-60
89
-54
105
000000000000000000000000000000000000000000000000000000000000000000000000000000000000000000000000000000000000000000000000000000000000000000000000000000
000000000000000000000000000001111111000000000000000011111111000000000000000000000000000000000000000000000000000000000000000000000000000000000000000000
000000000000000000000000000011111111100000000000000111111111100000000000000000000000000000000000000000000000000000000000000000000000000001110000000000
000000000000000000000000011111111111110000000000001111111111100000000000000000000000000000000000000000000000000001100000000000000000000011111110000000
000000000000000000000000111111111111111000000000011111111111100000000000000000000000000000000000000000000000000011110000000000000000000011111110000000
000000000000000000000000111111111111111100000000111111111111100000000000000000000000011111110000000000000000000111111000000000000000000011111110000000
000000000000000000000000111111111111111110000001111111111111100000000000000000000000111111111000000000000000001111111111100000000000000111111111000000
000000000000000000000001111111111111111111000001111111111111100000000000000000000001111111111100000000000000001111111111100000011000000111111111000000
000000000000000000000011111111111111111111100001111111111111100000000000000000000011111111111110000000000000011111111111100000111100001111111111100000
000000000000000001111111111111111111111111111111111111111111100000000000000000000111111111111111111100000000111111111111110001111111111111111111100000
000000000000000011111111111111111111111111111111111111111111100000000000000000001111111111111111111110000000111111111111111111111111111111111111100000
000000000000000111111111111111111111111111111111111111111111100000000000000000011111111111111111111110000011111111111111111111111111111111111111100000
000000000000000111111111111111111111111111111111111111111111110000000000000000111111111111111111111111100111111111111111111111111111111111111111100000
000000000000000111111111111111111111111111111111111111111111111100000000000001111111111111111111111111111111111111111111111111111111111111111111100000
000000000000000111111111111111111111111111111111111111111111111110000000000011111111111111111111111111111111111111111111111111111111111111111111100000
000000000000000111111111111111111111111111111111111111111111111110000000000111111111111111111111111111111111111111111111111111111111111111111110000000
000000000000000111111111111111111111111111111111111111111111111111000000001111111111111111111111111111111111111111111111111111111111111111111110000000
000000000000000111111111111111111111111111111111111111111111111111111111111111111111111111111111111111111111111111111111111111111111111111111100000000
000000000000000111111111111111111111111111111111111111111111111111111111111111111111111111111111111111111111111111111111111111111111111111110000000000
000000000000011111111111111111111111111111111111111111111111111111111111111111111111111111111111111111111111111111111111111111111111111111100000000000
000000000000111111111111111111111111111111111111111111111111111111111111111111111111111111111111111111111111111111111111111111111111111110000000000000
000000000001111111111111111111111111111111111111111111111111111111111111111111111111111111111111111111111111111111111111111111111111111110000000000000
000000000001111111111111111111111111111111111111111111111111111111111111111111111111111111111111111111111111111111111111111111111111111110000000000000
000000000001111111111111111111111111111111111111111111111111111111111111111111111111111111111111111111111111111111111111111111111111111110000000000000
000000000011111111111111111111111111111111111111111111111111111111111111111111111111111111111111111111111111111111111111111111111111111110000000000000
000000000011111111111111111111111111111111111111111111111111111111111111111111111111111111111111111111111111111111111111111111111111111110000000000000
000000000011111111111111111111111111111111111111111111111111111111111111111111111111111111111111111111111111111111111111111111111111111110000000000000
000000000011111111111111111111111111111111111111111111111111111111111111111111111111111111111111111111111111111111111111111111111111111110000000000000
000000000011111111111111111111111111111111111111111111111111111111111110000000001111111111111111111111111111111111111111111111111111111110000000000000
000000000011111111111111111111111111111111111111111111111111111111000000000000001111111111111111111111111111111111111111111111111111111110000000000000
000000000011111111111111111111111111111111110000011111111111111110000000000000000111111111111111111111111111111111111111111111111111111110000000000000
000000000011111111111111111111111111111111000000011111111111111110000000000000000111111111111111111111111111111111111111111111111111111110000000000000
000000000011111111111111111111111111111100000000001111111111111000000000000000000111111111111111111111111111110000000000011111111111111110000000000000
000000000111111111111111111111111111111000000000000000111111111000000000000000000111111111111111111111111111100000000000001111111111111110000000000000
000000000111111011111111111111111111000000000000000000111111111000000000000000000111111111111111111111111111000000000000001111111111111110000000000000
000000000111111111111111111111111100000000000000000001111111111000000000000000001111111111111111111111110000000000000000001111111111111110000000000000
000000001111111111111111111111111000000000000000000011111111111000000000000000001111111111111111111111100000000000000000001111111111111110000000000000
000000001111111111111111111111111000000000000000000111111111111000000000000000011111111111111111111111100000000000000000001111111111111110000000000000
000000011111111111111111111111111000000000000000001111111111111000000000000000111111111111111111111111100000000000000000001111111111111110000000000000
000000011111111111111111111111111000000000000000011111111111111000000000000001111111111111111111111111100000000000000000001111111111111110000000000000
000000011111111111111111111111111000000000000000011111111111111000000000000001111111111111111111111111100000000000000000001111111111111110000000000000
000000011111111111111111111111111000000000000000011111111111111000000000000001111111111111111111111111100000000000000000001111111111111110000000000000
000000011111111111111111111111111000000000000000111111111111111000000000000001111111111111111111111111100000000000000000001111111111111110000000000000
000000000111111111111111111111111100000000000001111111111111111000000000000001111111111111111111111111100000000000000000011111111111111110000000000000
000000000111111111111111111111111110000000000011111111111111111000000000000011111111111111111111111111100000000000000000011111111111111110000000000000
000000000111111111111111111111111110000000001111111111111111111000000000000111111111111111111111111111100000000000000000111111111111111110000000000000
000000000111111111111111111111111111111111111111111111111111111000000000001111111111111111111111111111100000000000000001111111111111111110000000000000
000000000111111111111111111111111111111111111111111111111111111111111111111111111111111111111111111111100000000000000001111111111111111000000000000000
000000000111111111111111111111111111111111111111111111111111111111111111111111111111111111111111111111100000000000000001111111111111111000000000000000
000000000111111111111111111111111111111111111111111111111111111111111111111111111111111111111111111111111000000000000001111111111111111000000000000000
000000000111111111111111111111111111111111111111111111111111111111111111111111111111111111111111111111111000000000000011111111111111111000000000000000
000000000001111111111111111111111111111111111111111111111111111111111111111111111111111111111111111111111111111111111111111111111111111000000000000000
000000000001111111111111111111111111111111111111111111111111111111111111111111111111111111111111111111111111111111111111111111111111111000000000000000
000000000000011111111111111111111111111111111111111111111111111111111111111111111111111111111111111111111111111111111111111111111111111000000000000000
000000000000011111111111111111111111111111111111111111111111111111111111111111111111111111111111111111111111111111111111111111111111111000000000000000
000000000000000000000000011111111111111111111111111111111111111111111111111111111111111100000000000000111111111111111111111111111111111000000000000000
000000000000000000000000011111111111111111111111111111111111111111111111111111111111111000000000000000011111111111111111111111111111111000000000000000
000000000000000000000000000111111111111111111111111111111111111111111111111111111111111000000000000000001111111111111111111111111111111000000000000000
000000000000000000000000000111111111111111111111111111111111111111111111111111111111111000000000000000001111111111111111111111111111111000000000000000
000000000000000000000000000001111111111111111111111111111111111111111111111111111111000000000000000000001111111111111111111111111111111000000000000000
000000000000000000000000000001111111111111111111111111111111111111111111111111111110000000000000000000001111111111111111111111111111111000000000000000
000000000000000000000000000001111111111111111111111111111111111111111111111111111110000000000000000000000111111111111111111111111111111000000000000000
000000000000000000000000000001111111111111111111111111111111111111111111111111111110000000000000000000000111111111111111111111111111111000000000000000
000000000000000000000000000001111111111111111111111111111111111111111111111111111110000000000000000000000111111111111111111111111111111100000000000000
000000000000000000000000000001111111111111111111111111111111111111111111111111111110000000000000000000000111111111111111111111111111111110000000000000
000000000000000000000000000001111111111111111111111111111111111111111111111111111110000000000000000000001111111111111111111111111111111111111111111100
000000000000000000000000000001111111111111111111111111111111111111111111111111111110000000000000000000001111111111111111111111111111111111111111111110
000000000000000000000000000001111111111111111111111111111111111111111111111111111110000000000000000000001111111111111111111111111111111111111111111110
000000000000000000000000000111111111111111111111111111111111111111111111111111111110000000000000000000000111111111111111111111111111111111111111111110
000000000000000000000000000111111111111111111111111111111111111111111111111111111110000000000000000000000111111111111111111111111111111111111111111110
000000000000000000000000000111111111111111111111111111111111111111111111111111111110000000000000000000000111111111111111111111111111111111111111111110
000000000000000000000000000111111111111111111111111111111111111111111111111111111110000000000000000000000111111111111111111111111111111111111111111110
000000000000000000000000000111111111111111111111111111111111111111111111111111111110000000000000000000001111111111111111111111111111111111111111111110
000000000000000000000000000111111111111111111111111111111111111111111111111111111111100000000000000000001111111111111111111111111111111111111111111110
000000000000000000000000001111111111111111111111111111111111111111111111111111111111100000000000000000011111111111111111111111111111111111111111111110
000000000000000000000000011111111111111111111111111111111111111111111111111111111111111110000000000000011111111111111111111111111111111111111111111110
000000000000000000000000011111111111111111111111111111111111111111111111111111111111111110000000000000011111111111111111111111111111111111111111111110
000000000000000000000000011111111111111111111111111111111111111111111111111111111111111111100000000000011111111111111111111111111111111111111111111110
000000000000000000000000111111111111111111111111111111111111111111111111111111111111111111100000000000111111111111111111111111111111111111111111111110
000000000000000000000000111111111111111111111111111111111111111111111111111111111111111111111111111111111111111111111111111111111111111111111111111110
000000000000000000000000111111111111111111111111111111111110000001111111111111111111111111111111111111111111111111111111111111111111111111111111111110
000000000000000000000000111111111111111111111111111111111100000001111111111111111111111111111111111111111111111111111111111111111111111111111111111110
000000000000000000000000111111111111111111111111111111111000000001111111111111111111111111111111111111111111111111111111111111111111111111111111111110
000000000000000000000000111111111111111111111111111111100000000001111111111111111111111111111111111111111111111111111111111111111111111111111111111110
000000000000000000000000111111111111111111111111111110000000000001111111111111111111111111111111111111111111111111111111111111111111111111111111111110
000000000000000000000000111111111111111111111111111110000000000011111111111111111111111111111111111111111111111111111111111111111111111111111111111110
000000000000000000000000111111111111111111111111111110000000000011111111111111111111111111111111111111111111111111111111111111111111111111111111111110
000000000000000000000001111111111111111111111111111110000000000011111111111111111111111111111111111111111111111111111111111111111111111111111111111000
000000000000000000000001111111111111111111111111111110000000000011111111111111111111111111111111111111111111111111111111111111111111111111111110000000
000000000000000000000001111111111111111111111111111110000000000111111111111111111111111111111111111111111111111111111111111111111111111111111000000000
000000000000000000000001111111111111111111111111111110000000000111111111111111111111111111111111111111111111111111111111111111111111111111110000000000
000000000000000000000011111111111111111111111111111110000000001111111111111111111111111111111111111111111111111111111111111111111111111111100000000000
000000000000000000000011111111111111111111111111111110000000011111111111111111111111111111111111111111111111111111111111111111111111111111000000000000
000000000000000000000011111111111111111111111111111110000000111111111111111111111111111111111111111111111111111111111111111111111111111110000000000000
000000000000000000000011111111111111111111111111111110000000111111111111111111111111111111111111111111111111111111111111111111111111111110000000000000
000000000000000000000011111111111111111111111111111111000001111111111111111111111111111111111111111111111111111111111111111111111111111110000000000000
000000000000000000000011111111111111111111111111111111100011111111111111111111111111111111000000000000000000001111111111111111111111111110000000000000
000000000000000000000011111111111111111111111111111111111111111111111111111111111111111100000000000000000000001111111111111111111111111110000000000000
000000000000000000000011111111111111111111111111111111111111111111111111111111111111111100000000000000000000000011111111111111111111111110000000000000
000000000000000000000111111111111111111111111111111111111111111111111111111111111111110000000000000000000000000011111111111111111111111111000000000000
000000000000000000000111111111111111111111111111111111111111111111111111111111111111110000000000000000000000000011111111111111111111111111110000000000
000000000000000000000111111111111111111111111111111111111111111111111111111111111111110000000000000000000000000011111111111111111111111111111000000000
000000000000000000000111111111111111111111111111111111111111111111111111111111111111110000000000000000000000000011111111111111111111111111111000000000
000000000000000000001111111111111111111111111111111111111111111111111111111111111111110000000000000000000000000011111111111111111111111111111000000000
000011000000000000011111111111111111111111111111111111111111111111111111111111111111110000000000000000000000000011111111111111111111111111111000000000
000111000000000000111111111111111111111111111111111111111111111111111111111111111111110000000000000000000000000011111111111111111111111111111000000000
001111111111111111111111111111111111111111111111111111111111111111111111111111111111110000000000000000000000000011111111111111111111111111111000000000
001111111111111111111111111111111111111111111111111111111111111111111111111111111111110000000000000000000000000011111111111111111111111111111000000000
001111111111111111111111111111111111111111111111111111111111111111111111111111111111110000000000000000000000000111111111111111111111111111111000000000
001111111111111111111111111111111111111111111111111111111111111111111111111111111111110000000000000000000000000111111111111111111111111111111000000000
001111111111111111111111111111111111111111111111111111111111111111111111111111111111111100000000000000000000000111111111111111111111111111111000000000
001111111111111111111111111111111111111111111111111111111111111111111111111111111111111100000000000000000000000111111111111111111111111111111000000000
001111111111111111111111111111111111111111111111111111111111111111111111111111111111111100000000000000000000011111111111111111111111111111111000000000
001111111111111111111111111111111111111111111111111111111111111111111111111111111111111100000000000000000000011111111111111111111111111111111000000000
001111111111111111111111111111111111111111111111111111111111111111111111111111111111111111000000000000000001111111111111111111111111111111111000000000
001111111111111111111111111111111111111111111111111111111111111111111111111111111111111111000000000000000001111111111111111111111111111111111000000000
001111111111111111111111111111111111111111111111111111111111111111111111111111111111111111110000000000000111111111111111111111111111111111111000000000
001111111111111111111111111111111111111111111111111111111111111111111111111111111111111111110000000000000111111111111111111111111111111111111000000000
001111111111111111111111111111111111111111111111111111111111111111111111111111111111111111110000000000011111111111111111111111111111111111111000000000
001111111111111111111111111111111111111111111111111111111111111111111111111111111111111111110000000000011111111111111111111111111111111111111000000000
001111111111111111111111111111111111111111111111111111111111111111111111111111111111111111111111111111111111111111111111111111111111111111111000000000
001111111111111111111111111111111111111111111111111111111111111111111111111111111111111111111111111111111111111111111111111111111111111111111000000000
001111111111111111111111111111111111111111111111111111111111111111111111111111111111111111111111111111111111111111111111111111111111111111111000000000
001111111111111111111111111111111111111111111111111111111111111111111111111111111111111111111111111111111111111111111111111111111111111111111000000000
001111111111111111111111111111111111111111111111111111111111111111111111111111111111111111111111111111111111111111111111111111111111111111111000000000
001111111111111111111111111111111111111111111111111111111111111111111111111111111111111111111111111111111111111111111111111111111111111111111000000000
001111111111111111111111111111111111111111111111111111111111111111111111111111111111111111111111111111111111111111111111111111111111111111111000000000
001111111111111111111111111111111111111111111111111111111111111111111111111111111111111111111111111111111111111111111111111111111111111111111000000000
001111111111111111111111111111111111111111111111111111111111111111111111111111111111111111111111111111111111111111111111111111111111111111111000000000
001111111111111111111111111111111111111111111111111111111111111111111111111111111111111111111111111111111111111111111111111111111111111111111000000000
001111111111111111111111111111111111111111111111111111111111111111111111111111111111111111111111111111111111111111111111111111111111111111110000000000
001111111111111111111111111111111111111111111111111111111111111111111111111111111111111111111111111111111111111111111111111111111111111111100000000000
001111111111111111111111111111111111111111111111111111111111111111111111111111111111111000000001111111111111111111111111111111111111111111000000000000
001111111111111111111111111111111111111111111111111111111111100000111111111111111111110000000001111111111111111111111111111111111111111110000000000000
001111111111111111111111111111111111111111111111111111111111000000111111111111111111100000000001111111111111111111111111111111111111111110000000000000
001111111111111111111111111111111111111111111111111000000000000000111111111111110000000000000001111111111111111111111111111111111111111100000000000000
001111111111111111111111111111111111111111111111110000000000000000111111111111000000000000000001111111111111111111111111111111111111111000000000000000
001111111111111111111111111111111111111111111111110000000000000000111111111110000000000000000001111111111111111111111111111111111111110000000000000000
001111111111111111111111111111111111111111111111110000000000000000111111111100000000000000000001111111111111111111111111111111111111100000000000000000
011111111111111111111111111111111111111111111111110000000000000000111111111000000000000000000001111111111111111111111111111111111111000000000000000000
111111111111111111100000000000111111111111111111110000000000000000111111110000000000000000000001111111111111110001111111111111111110000000000000000000
111111111111111111000000000000111111111111111111110000000000000000111111100000000000000000000001111111111111100001111111111111111100000000000000000000
011111111111111110000000000000111111111111111111110000000000000000111111000000000000000000000001111111111111000001111111111111110000000000000000000000
001111111111111000000000000000111111111111111111110000000000000001111111000000000000000000000001111111111100000001111111111111100000000000000000000000
000000000000000000000000000000111111111111111111110000000000000001111110000000000000000000000001111111111100000000111100000000000000000000000000000000
000000000000000000000000000000111111111111111111110000000000000011111110000000000000000000000001111111111000000000000000000000000000000000000000000000
000000000000000000000000000000111111111111111111110000000000000111111110000000000000000000000001111111111000000000000000000000000000000000000000000000
000000000000000000000000000000111111111111111111110000000000001111111110000000000000000000000001111111111000000000000000000000000000000000000000000000
000000000000000000000000000000111111111111111111111111111111111111111110000000000000000000000001111111111000000000000000000000000000000000000000000000
000000000000000000000000000000111111111111111111111111111111111111111110000000000000000000000001111111110000000000000000000000000000000000000000000000
000000000000000000000000000000111111111111111111111111111111111111111110000000000000000000000001111111100000000000000000000000000000000000000000000000
000000000000000000000000000000111111111111111111111111111111111111111110000000000000000000000001111111000000000000000000000000000000000000000000000000
000000000000000000000000000000111111111111111111111111111111111111111110000000000000000000000001111110000000000000000000000000000000000000000000000000
000000000000000000000000000000111111111111111111111111111111111111111100000000000000000000000001111100000000000000000000000000000000000000000000000000
000000000000000000000000000000111111111111111111111111111111111111111000000000000000000000000001111000000000000000000000000000000000000000000000000000
000000000000000000000000000000111111111111111111111111111111111111110000000000000000000000000000000000000000000000000000000000000000000000000000000000
000000000000000000000000000000111111111111111111111111111111111111100000000000000000000000000000000000000000000000000000000000000000000000000000000000
000000000000000000000000000000111111111111111111111111111111111111000000000000000000000000000000000000000000000000000000000000000000000000000000000000
000000000000000000000000000000111111111111111111111111111111111110000000000000000000000000000000000000000000000000000000000000000000000000000000000000
000000000000000000000000000000111111111111111111111111111111111100000000000000000000000000000000000000000000000000000000000000000000000000000000000000
