-57
89
-41
106
000000000000000000000000000000000000000000000000000000000000000000000000000000000000000000000000000000000000000000000000000000000000000000000000000
000000111111111111111111111111100000000000000000000000000000000000000000000000000000000000000000000000000000000000000000000000000000000000000000000
000000111111111111111111111111100000000000000000000000000000000000000000000000000000000000000000000000000000000000000000000000000000000000000000000
000000111111111111111111111111100000000000000000111111111111100000000000000000000000000000000011111110000000000000000000000000000000000000000000000
000000111111111111111111111111100000000000000001111111111111100000000000000000000000000000000011111110000000000000000000000000000000000000000000000
000001111111111111111111111111111111100000000011111111111111100000000000000000000000000000111111111110000000000000000000000000000000000000000000000
000001111111111111111111111111111111100000000111111111111111100000000000000000000000000001111111111110000000000000001111110000000000000000000000000
000011111111111111111111111111111111100000001111111111111111100000000000000000000000000011111111111110000000000000011111110000000000000000000000000
000111111111111111111111111111111111100000001111111111111111000000000000000000000000000111111111111110000000000000011111110000000000000000000000000
000111111111111111111111111111111111111111111111111111111111000000000000000000000000001111111111111110000000000000111111110000000000000000000000000
001111111111111111111111111111111111111111111111111111111110000000000000000011111111111111111111111110000000000001111111110000000000000000000000000
001111111111111111111111111111111111111111111111111111111110000000000000000011111111111111111111111110000000000001111111110000000000000000000000000
011111111111111111111111111111111111111111111111111111111110000000000000000011111111111111111111111110000000000001111111110000000000000000000000000
011111111111111111111111111111111111111111111111111111111110000000000000000011111111111111111111111110000000000011111111110000000000000000000000000
011111111111111111111111111111111111111111111111111111111110000000000000000011111111111111111111111110000000000011111111110000000000000000000000000
001111111111111111111111111111111111111111100000001111111111111000011111111111111111111111111111111110000000000011111111110000000000000000000000000
001111111111111111111111111111111111111110000000001111111111111100011111111111111111111111111111111110000000000111111111111111111111111111000000000
000111111111111111111111111111111111111000000000001111111111111111111111111111111111111111111111111110000000001111111111111111111111111111000000000
000001111111111111111111111111111111110000000000001111111111111111111111111111111111111111111111111111111111111111111111111111111111111111000000000
000001111111111111111111111111111111110000000000001111111111111111111111111111111111111111111111111111111111111111111111111111111111111111000000000
000001111111111111111111111111111110000000000000001111111111111111111111111111111111111111111111111111111111111111111111111111111111111111000000000
000001111111111111111111111111111100000000000000001111111111111111111111111111111111111111111111111111111111111111111111111111111111111111000000000
000001111111111111111111111111100000000000000000001111111111111111111111111111111111111111111111111111111111111111111111111111111111111111000000000
000000111111111111111111111100000000000000000000001111111111111111111111111111111111111111111111111111111111111111111111111111111111111111000000000
000000111111111111111111100000000000000000000000011111111111111111111111111111111111111111111111111111111111111111111111111111111111111111000000000
000000111111111111111110000000000000000000000000011111111111111111111111111111111111111111111111111111111111111111111111111111111111111111000000000
000000111111111111111110000000000000000000000000111111111111111111111111111111111111111111111111111111111111111111111111111111111111111111000000000
000001111111111111111111000000000000000000000001111111111111111111111100000011111111111111111111111111111111111111111111111111111111111111000000000
000001111111111111111111000000000000000000000011111111111111111111111000000001111111111111111111111111111111111111111111111111111111111110000000000
000001111111111111111110000000000000000000000111111111111111111111000000000001111111111111111111111111111111111111111111111111111111111100000000000
000001111111111111111100000000000000000000001111111111111111111111000000000001111111111111111111111111111111111111111111111111111111110000000000000
000000111111111111111100000000000000000000011111111111111111100000000000000001100111111111111111111111111111111111111111111111111111110000000000000
000000111111111111111100000000000000000000011111111111111111000000000000000000000111111111111111111111111111111111111111111111111111111000000000000
000000111111111111111100000000000000000000111111111111111110000000000000000000000111111111111111111111111111111111111111111111111111111100000000000
000000001111111111111100000000000000000001111111111111111100000000000000000000000111111111111111111111111111111111111111111111111111111111000000000
000000001111111111111100000000000000000011111111111111111000000000000000000000000111111111111100000001111111111111000000011111111111111111000000000
000000000111111111111110000000000000000111111111111111110000000000000000000000000111111111111000000001111111111110000000011111111111111111100000000
000000000011111111111111000000000000001111111111111111100000000000000000000000000111111111100000000001111111111100000000011111111111111111100000000
000000000001111111111111100000000000011111111111111111000000000000000000000000001111111111000000000000111111110000000000011111111111111100000000000
000000000000111111111111111000000000111111111111111111000000000000000000000000011111111110000000000000111111110000000000011111111111111100000000000
000000000000111111111111111100000001111111111111111111000000000000000000000000011111111100000000000000111111111000000000011111111111111100000000000
000000000000011111111111111110001111111111111111111111000000000000000000000000111111111000000000000001111111111000000000011111111111111100000000000
000000000000001111111111111111111111111111111111111111000000000000000000000000111111110000000000000011111111111000000000111111111111111100000000000
000000000000001111111111111111111111111111111111111111000000000000000000000000111111110000000000000111111111110000000001111111111111111100000000000
000000000000000011111111111111111111111111111111111111000000000000000000000001111111111000000000000111111111110000000001111111111111111100000000000
000000000000000001111111111111111111111111111111111111000000000000000000000001111111111000000000000111111111111000110011111111111111111100000000000
000000000000000000111111111111111111111111111111111111000000000000000000000011111111110000000000001111111111111111111111111111111111111100000000000
000000000000000000011111111111111111111111111111111111000000000000000000000111111111110000000000011111111111111111111111111111111111111100000000000
000000000000000000001111111111111111111111111111111111100000000000000000001111111111110000000000111111111111111111111111111111111111111100000000000
000000000000000000000011111111111111111111111111111111100000000000000000001111111111110000011001111111111111111111111111111111111111111100000000000
000000000000000000000011111111111111111111111111111111100000000000000111111111111111111111111111111111111111111111111111111111111111111111000000000
000000000000000000000011111111111111111111111111111111100000000000001111111111111111111111111111111111111111111111111111111111111111111111000000000
000000000000000000000011111111111111111111111111111111100000000000011111111111111111111111111111111111111111111111111111111111111111111111000000000
000000000000000000000011111111111111111111111111111111111111000000011111111111111111111111111111111111111111111111111111111111111111111111000000000
000000000000000000000011111111111111111111111111111111111111111111111111111111111111111111111111111111111111111111111111111111111111111111000000000
000000000000000000000011111111111111111111111111111111111111111111111111111111111111111111111111111111111111111111111111111111111111111111000000000
000000000000000000001111111111111111111111111111111111111111111111111111111111111111111111111111111111111111111111111111111111111111111111000000000
000000000000000000001111111111111111111111111111111111111111111111111111111111111111111111111111111111111111111111111111111111111111111111000000000
000000000000000000001111111111111111111111111111111111111111111111111111111111111111111111100111111111111111111111111111111111111111111111000000000
000000000000000000001111111111111111111111111111111111111111111111111111111111111111100000000000011111111111111111111111111111111111111111000000000
000000000000000000000011111111111111111111111111111111111111111111111111111111111111000000000000001111111111111111111111111111111111111111110000000
000000000000000000000011111111111111111111111111111111111111111111111111111111111110000000000000000011111111111111111111111111111111111111110000000
000000000000000000000011111111111111111111111111111111100111111111111111111111111100000000000000000001111111111111111111111111111111111111111000000
000000000000000000000011111111111111111111111111111111000111111111111111111111111100000000000000000001111111111111111111111111111111111111111000000
000000000000000000000011111111111111111111111111111110000111111111111111111111111100000000000000000001111111111111111111111111111111111111110000000
000000000000000000000011111111111111111111111111111000000111111111111111111111111100000000000000000001111111111111111111111111111111111111000000000
000000000000000000000000111111111111111111111111110000000111111111111111111111111100000000000000000001111111111111111111111111111111111111000000000
000000000000000000000000111111000000111111111111100000000000011111111111111111111100000000000000000001111111111111111100010001111111111111000000000
000000000000000000000000001110000001111111111111100000000000011111111111111111111100000000000000000001111111111111111000000001111111111111000000000
000000000000000000000000000000000000111111111111000000000000011111111111111111111110000000000000000001111111111111110000000011111111111111000000000
000000000000000000000000000000000000111111111110000000000000011111111111111111111111111111000000000011111111111111100000000011111111110000000000000
000000000000000000000000000000000000111111111110000000000000011111111111111111111111111111000000000111111111111111000000000111111111110000000000000
000000000000000000000000000000000000111111111111000000000000011111111111111111111111111111000000000111111111111111000000001111111111110000000000000
000000000000000000000000000000000000111111111111000000000000011111111111111111111111111111100000001111111111111111000000011111111111110000000000000
000000000000000000000000000000000000111111111110000000000000011111111111111111111111111111111111111111111111111111000000011111111111110000000011110
000000000000000000000000000000000000111111111000000000000000000000000111111111111111111111111111111111111111111111000000111111111111110000000011110
000000000000000000000000000000000001111111110000000000000000000000000111111111111111111111111111111111111111111111100001111111111111110000000011110
000000000000000000000000000000000001111111100000000000000000000000000111111111111111111111111111111111111111111111110001111111111111110000000011110
000000000000000000000000000000000001111111100000000000000000000000000011111111111111111111111111111111111111111111111111111111111111111111111111110
000000000000000000000000000000000001111111100000000000000000000000000000011111111111111111111111111111111111111111111111111111111111111111111111110
000000000000000000000000000000000001111111100000000000000000000000000000011111111111111111111111111111111111111111111111111111111111111111111111110
000000000000000000000000000000000011111111100000000000000000000000000000011111111111111111111111111111111111111111111111111111111111111111111111110
000000000000000000000000000000000011111111100000000000000000000000000000011111111111111111111111111111111111111111111111111111111111111111111111110
000000000000000000000000000000000011111111100000000000000000000000000000011111111111111111110000001111111111111111111111111111111111111111111111110
000000000000000000000000000000000011111111100000000000000000000000000000011111111100001100000000001111111111111111111111111111111111111111111111110
000000000000000000000000000000000011111111100000000000000000000000000000011111111100001000000000001111111111111111111111111111111111111111111111110
000000000000000000000000000000000111111111100000000000000000000000000000000000000000000000000000001111111111111111111111111111111111111111111111110
000000000000000000000000000000000011111111100000000000000000000000000000000000000000000000000000011111111111111111111111110000000111111111111111110
000000000000000000000000000000000011111111100000000000000000000000000000000000000000000000000000011111111111111111111111100000000111111111111111110
000000000000000000000000000000000011111111100000000000000000000000000000000000000000000000000000111111111111111111111111000000000111111111111111110
000000000000000000000000000000000011111111111110000000000000000000000000000000000000000000000001111111111111111111111110000000000111111111111111110
000000000000000000000000000000000111111111111110000000000000000000000000000000000000000000000011111111111111111111111110000000000111111111000000000
000000000000000000000000000000001111111111111110000000000000000000000000000000000000000000000011111111111111111111111110000000000111111110000000000
000000000000000000000000000000001111111111111111111000000000000000000000000000000000000000000111111111111111111111111111000000000111111100000000000
000000000000000000000000000000011111111111111111111100000000000000000000000000000000000000000111111111111111111111111111110000001111111000000000000
000000000000000000000000000000011111111111111111111111100000000000000000000000000000000000001111111111111111111111111111110000011111110000000000000
000000000000000000000000000000111111111111111111111111100000000000000000111111111000000000001111111111111111111111111111111000111111100000000000000
000000000000000000000000000001111111111111111111111111111111111100000000111111111100000000001111111111111111111111111111111100111110000000000000000
000000000000000000000000000011111111111111111111111111111111111100000000111111111110000000001111111111111111111111111111111111111100000000000000000
000000000000000000000000000011111111111111111111111111111111111100000000111111111111111111111111111111111111111111111111111111111100000000000000000
000000000000000000000000000111111111111111111111111111111111111100000000111111111111111111111111111111111111111111111111111111111110000000000000000
000000000000000000000000000111111111111111111111111111111111111100000000111111111111111111111111111111111111111111111111111111111111011000000000000
000000000000000000000000001111111111111111111111111111111111111100000000111111111111111111111111111111111111111111111111111111111111111111000000000
000000000000000011111111111111111111111111111111111111111111111100000000111111111111111111111111111111111111111111111111111111111111111111000000000
000000000000011111111111111111111111111111111111111111111111111111111111111111111111111111111111111111111111111111111111111111111111111111000000000
000000000000011111111111111111111111111111111111111111111111111111111111111111111111111111111111111111111111111111111111111111111111111111000000000
000000000000111111111111111111111111111111111111111111111111111111111111111111111111111111111111111111111111111111111111111111111111111111000000000
000000000000111111111111111111111111111111111111111111111111111111111111111111111111111111111111111111111111100001111111111111111111111111000000000
000000000000111111111111111111111111111111111111111111111111111111111111111111111111111111111111111111111111000001111111111111111111111111100000000
000000000000111111111111111111111111111111111111111111111111111111111111111111111111111111111111111111111110000001111111111111111111111111100000000
000000000000111111111111111111111111111111111111111111111111111111111111111111111111111111111111111111111100000001111111111111111111111111100000000
000000000001111111111111111111111111111111111111111100000111111111111111111111111111111111111111111111111100000011111111111111111111111110000000000
000000000011111111111111111111111111111111111111100000000111111111111111111111111111111111111111111111111100000111111111111111111111111100000000000
000000000011111111111111111111111111111111111111000000000111111111111111111111111111111111111111111111111110001111111111111111111111111000000000000
000000000011111111111111111111111111111111111100000000000111111111111111111111111111111111111111111111111111111111111111111111111111110000000000000
000000000111111111111111111111111111111111111000000000000000000000001111111111111111111111111111111111111111111111111111111111111111100000000000000
000000000111111111111111111111111111111111110000000000000000000000001111111111111111111111111111111111111111111111111111111111111111000000000000000
000000001111111111111111111111111111111111100000000000000000000000001111111111111111111111111111111111111111111111111111111111111110000000000000000
000000001111111111111111111111111111111111000000000000000000000000001111111111111111111111111111111111111111111111111111111111111100000000000000000
000000011111111111111111111111111111111111000000000000000000000000011111111111111111110001111111111111111111111111111111111111111100000000000000000
000000011111111111111111111111111111111111000000000000000000000000011111111111111111000000111111111111111111111111111111111111111100000000000000000
001111111111111111111111111111111111111111110000000000000000000000111111111111111110000000011111111111111111111111111111111111111100000000000000000
011111111111111111111111111111111111111111111100000000000000000001111111111111111100000000001111111111111111111111111111111111111100000000000000000
111111111111111111111111111111111111111111111100000000000000000011111111111111111100000000000111111111111111111111111111111111111100000000000000000
111111111111111111111111111111111111111111111100000000000000000111111111111111111100000000000111111111111111111111111111111111111100000000000000000
111111111111111111111111111111111111111111111100000000000000001111111111111111111100000000000111111111111111111111111111111111111110000000000000000
111111111111111111111111111111111111111111111100000000000000001111111111111111111100000000001111111111111111111111111111111111111111111111000000000
111111111111111111111111111111111111111111111100000000000111111111111111111111111100000000001111111111111111111111111111111111111111111111000000000
111111111111111111111111111111111111111111111110000000000111111111111111111111111110000000011111111111111111111111111111111111111111111111000000000
111111111111111111111111111111111111111111111110000000001111111111111111111111111111000000111111111111111111111111111111111111111111111111000000000
111111111111111111111111111111111111111111111100000000001111111111111111111111111111111111111111111111111111111111111111111111111111111111000000000
111111111111111111111111111111111111111111111000000000011111111111111111111111111111111111111111111111111111111111111111111111111111111111000000000
111111111111111111111111111111111111111111110000000000111111111111111111111111111111111111111111111111111111111111111111111111111111111111000000000
111111111111111111111111111111111111111111100000000001111111111111111111111111111111111111111111111111111111111111111111111111111111111111000000000
111111111111111111111111111111111111111111000000000001111111111111111111111111111111111111111111111111111111111111111111111111111111111111000000000
011111111111111111111111111111111111111111000000000001111111111111111111111111111110001111111111111111111111111111111111111111111111111111000000000
000011111111111111111111111111111111111110000000000001111111111111111111111111111000001111111111111111111111111111111111111111111111111110000000000
000011111111111111111111111111111111111100000000000001111111111111111111111111110000011111111111111111111111111111111111111111111111111110000000000
000011111111111111111111111111111111111000000000000001111111111111111111111111100000011111111111111111111111111111111111111111111111111000000000000
000011111110011111111111111111111111110000000000000001111111111111111111110000000000011111111111111111111111110001111111111111111111100000000000000
000001111000011111111111111111111111100000000000000000111111111111111111100000000000011111111111111111111111100000001111111111111110000000000000000
000001110000011111111111111111111111000000000000000000011111111111111111000000000000011111111111111111111110000000001111111111111110000000000000000
000000000000011111111111111111111110000000000000000000001111111111111100000000000000011111111111111111111100000000001111111111100110000000000000000
000000000000000000000000000000000000000000000000000000000111111111111100000000000000111111111111110001111000000000000000011111000110000000000000000
000000000000000000000000000000000000000000000000000000000011111111111100000000000001111111111000000000111000000000000000011110000000000000000000000
000000000000000000000000000000000000000000000000000000000011111111100000000000000011111111110000000000000000000000000000011000000000000000000000000
000000000000000000000000000000000000000000000000000000000001111111000000000000000011111111100000000000000000000000000000000000000000000000000000000
000000000000000000000000000000000000000000000000000000000000111111000000000000000000000000000000000000000000000000000000000000000000000000000000000
