102
258
-42
128
0000000000000000000000000000000000000000000000000000000000000000000000000000000000000000000000000000000000000000000000000000000000000000000000000000000000000
0000000000000000000000000000000000000000000000000000000000000000000000000000000000000011111111000000000000000000000000000000000000000000000000000000000000000
0000000000000000000000000000000000000000000000000000000000000000000000000000000000000011111111000000000000000000000000000000000000000000000000000000000000000
0000000000000000000000000000000000000000000000000000000000000000000000000000000000001111111111000000000000000000000000000000000000000000000000000000000000000
0000000000000000000000000000000000000000000000000000000000000000000000000000000000001111111111000000000000000000000000000000000000000000000000000000000000000
0000000000000000000000000000000000000000000000000000000000000000000000000000000000001111111111110000000000000000000000000000000000000000000000000000000000000
0000000000000000000000000000000000000000000000000000000000000000000000000000000000001111111111110000000000000000000000000000000000000000000000000000000000000
0000000000000000000000000000000000000000000000000000000000000000000000000000000000111111111111110000000000000000000000000000000000000000000000000000000000000
0000000000000000000000000000000000000000000000000000000000000000000000000000000000111111111111110000000000000000000000000000000000000000000000000000000000000
0000000000000000000000000000000000000000000000000000000000000000000000000000000011111111111111110000000000000000000000000000000000000000000000000000000000000
0000000000000000000000000000000000000000000000000000000000000000000000000000000011111111111111110000000000000000000000000000000000000000000000000000000000000
0000000000000000000000000000000000000000000000000000000000000000000000000000001111111111111111110000000000000000000000000000000000000000000000000000000000000
0000000000000000000000000000000000000000000000000000000000000000000000000000001111111111111111110000000000000000000000000000000000000000000000000000000000000
0000000000000000000000000000000000000000000000000000111100000011110000000000001111111111111111110000000000000000000000000000000000000000000000000000000000000
0000000000000000000000000000000000000000000000000000111100000011110000000000001111111111111111110000000000000000000000000000000000000000000000000000000000000
0000000000000000000000000000000000000000000000000000111100000011110000000000111111111111111111110000000000000000000000000000000000000000000000000000000000000
0000000000000000000000000000000000000000000000000000111100000011110000000000111111111111111111110000000000000000000000000000000000000000000000000000000000000
0000000000000000000000000000000000000000000000000000000000000000000000000011111111111111111111000000001111111111000000000000000000000000000000000000000000000
0000000000000000000000000000000000000000000000000000000000000000000000000011111111111111111111000000001111111111000000000000000000000000000000000000000000000
0000000000000000000000000000000000000000000000000000000000000000000000001111111111111111111111111100111111111111000000000000000000000000000000000000000000000
0000000000000000000000000000000000000000000000000000000000000000000000001111111111111111111111111100111111111111000000000000000000000000000000000000000000000
0000000000000000000000000000000000000000000000000000000011111111000000111111111111111111111111111100111111111100000000000000000000000000000000000000000000000
0000000000000000000000000000000000000000000000000000000011111111000000111111111111111111111111111100111111111100000000000000000000000000000000000000000000000
0000000000000000000000000000000000000000000000000000000011111111000011111111111111111111111111000011111111111100111100111100000000000000000000000000000000000
0000000000000000000000000000000000000000000000000000000011111111000011111111111111111111111111000011111111111100111100111100000000000000000000000000000000000
0000000000000000000000000000000000000000001111110011111111111111001111111111001111111111110000001111111111111111111111111100111100000000000000000000000000000
0000000000000000000000000000000000000000001111110011111111111111001111111111001111111111110000001111111111111111111111111100111100000000000000000000000000000
0000000000000000000000000000000000000000001111111111111111111111111111111111111111111111110000111111111111111111111111111111111100000000000000000000000000000
0000000000000000000000000000000000000000001111111111111111111111111111111111111111111111110000111111111111111111111111111111111100000000000000000000000000000
0000000000000000000000000000000000000000111111111111111111000011110000000000001111111111110000000011110000111111111111111111110000000000000000000000000000000
0000000000000000000000000000000000000000111111111111111111000011110000000000001111111111110000000011110000111111111111111111110000000000000000000000000000000
0000000000000000000000000000000000111111111100111111111111000011110000000000001111111111110000000011110000111111111111111111111111110000000000000000000000000
0000000000000000000000000000000000111111111100111111111111000011110000000000001111111111110000000011110000111111111111111111111111110000000000000000000000000
0000000000000000000000000000000011111100000000111100000000000000000000000000001111111111110000000000000000111100001111111111111111110000000000000000000000000
0000000000000000000000000000000011111100000000111100000000000000000000000000001111111111110000000000000000111100001111111111111111110000000000000000000000000
0000000000000000000000000000111111111100000000111100000000000000000000000000001111111111110000000000000000111100001111111111111111110000000000000000000000000
0000000000000000000000000000111111111100000000111100000000000000000000000000001111111111110000000000000000111100001111111111111111110000000000000000000000000
0000000000000000000000000000111111111100000000000000000000000000000000000011111111111111110000000000000000000000000000000000001111110000000000000000000000000
0000000000000000000000000000111111111100000000000000000000000000000000000011111111111111110000000000000000000000000000000000001111110000000000000000000000000
0000000000000000000000000011111111111100000000000000000000000000000000000011111111111111110000000000000000000000000000000000001111110000000000000000000000000
0000000000000000000000000011111111111100000000000000000000000000000000000011111111111111110000000000000000000000000000000000001111110000000000000000000000000
0000000000000000000000001100000000000000000000000000000000000000000000111111111111111100000000000000000000000000000000000000000000111111110000000000000000000
0000000000000000000000001100000000000000000000000000000000000000000000111111111111111100000000000000000000000000000000000000000000111111110000000000000000000
0000000000000000000000111100000000000000000000000000000000000000000000111111111111111100000000000000000000000000000000000000000000111111110000000000000000000
0000000000000000000000111100000000000000000000000000000000000000000000111111111111111100000000000000000000000000000000000000000000111111110000000000000000000
0000000000000000000011000000000000000000000000111100000000000000001111111111111111111100000000111111111111111100000000000000000000111111000000000000000000000
0000000000000000000011000000000000000000000000111100000000000000001111111111111111111100000000111111111111111100000000000000000000111111000000000000000000000
0000000000000000000011000000000000000000000000111100000000000000001111111111111111111100000000111111111111111100000000000000000000111111000000000000000000000
0000000000000000000011000000000000000000000000111100000000000000001111111111111111111100000000111111111111111100000000000000000000111111000000000000000000000
0000000000000000001111000000001111000011111111111111111111111111111111111111111111000000001111000011111111111111110000000000000000111111111100000000000000000
0000000000000000001111000000001111000011111111111111111111111111111111111111111111000000001111000011111111111111110000000000000000111111111100000000000000000
0000000000000000111111000000001111000011111111111111111111111111111111111111111111000000001111000011111111111111110000000000000000111111111100000000000000000
0000000000000000111111000000001111000011111111111111111111111111111111111111111111000000001111000011111111111111110000000000000000111111111100000000000000000
0000000000001111110000111100001111111111111111000011111111111111111111111111111111111111111111111111111111111111111111000000000000111111111100000000000000000
0000000000001111110000111100001111111111111111000011111111111111111111111111111111111111111111111111111111111111111111000000000000111111111100000000000000000
0000000000001111110000111100001111111111111111000011111111111111111111111111111111111111111111111111111111111111111111000000000000111111111100000000000000000
0000000000001111110000111100001111111111111111000011111111111111111111111111111111111111111111111111111111111111111111000000000000111111111100000000000000000
0000000000001111110000000011111111111111111111111111111111111111111111111111111111111111111111111111111111111111111111000000000000000011111100000000000000000
0000000000001111110000000011111111111111111111111111111111111111111111111111111111111111111111111111111111111111111111000000000000000011111100000000000000000
0000111100001111110000000011111111111111111111111111111111111111111111111111111111111111111111111111111111111111111111000000000000000011111100000000000000000
0000111100001111110000000011111111111111111111111111111111111111111111111111111111111111111111111111111111111111111111000000000000000011111100000000000000000
0000111100001111110000000011111111111111111111111111111111111111111111111111111111000000001111111111111111111111111111000000000000000011111100000000000000000
0000111100001111110000000011111111111111111111111111111111111111111111111111111111000000001111111111111111111111111111000000000000000011111100000000000000000
0000000000001111110000000011111111111111111111111111111111111111111111111111111111000000001111111111111111111111111111000000000000000011111111110000000000000
0000000000001111110000000011111111111111111111111111111111111111111111111111111111000000001111111111111111111111111111000000000000000011111111110000000000000
0000000000001111110000000011111111111111111111111111111111111111111111111111111111000000001111111111110000111111110000111100000000000011111111110000000000000
0000000000001111110000000011111111111111111111111111111111111111111111111111111111000000001111111111110000111111110000111100000000000011111111110000000000000
0000000011001111110000000011111111111111111111111111111111111111111111111111111111000000001111111111110000111111110000111100000000000011111111111111000000000
0000000011001111110000000011111111111111111111111111111111111111111111111111111111000000001111111111110000111111110000111100000000000011111111111111000000000
0011000000111111110000000000001111111111111111111111111111111111111111111111111111000000001111111111111111111111110000000000000000000000001111111111000000000
0011000000111111110000000000001111111111111111111111111111111111111111111111111111000000001111111111111111111111110000000000000000000000001111111111000000000
0011000000001111110000000000001111111111111111111111111111111111111111111111111111000000001111111111111111111111110000000000000000000000001111111111111100000
0011000000001111110000000000001111111111111111111111111111111111111111111111111111000000001111111111111111111111110000000000000000000000001111111111111100000
0011000000111100000000000000001111111111111111111111111111111111111111111111111111111111111111111111111111111111111111000000000000111100000000111111111111000
0011000000111100000000000000001111111111111111111111111111111111111111111111111111111111111111111111111111111111111111000000000000111100000000111111111111000
0000000000111100000000000000001111111111111111111111111111111111111111111111111111111111111111111111111111111111111111000000000000111100000000111111111111000
0000000000111100000000000000001111111111111111111111111111111111111111111111111111111111111111111111111111111111111111000000000000111100000000111111111111000
0000000000111111110000000000000000111111111111111111111111111111111111111111111111111111111111111111111111111111111111111100000000000000000000000011111100000
0000000000111111110000000000000000111111111111111111111111111111111111111111111111111111111111111111111111111111111111111100000000000000000000000011111100000
0000000000111111110000000000000000111111111111111111111111111111111111111111111111111111111111111111111111111111111111111100000000000000000000000011110000000
0000000000111111110000000000000000111111111111111111111111111111111111111111111111111111111111111111111111111111111111111100000000000000000000000011110000000
0000000011111111110000111100000000000011111111111111110000111111111111111111111111111111111111111111110000111111111111111100000000000000000000000000000000000
0000000011111111110000111100000000000011111111111111110000111111111111111111111111111111111111111111110000111111111111111100000000000000000000000000000000000
1100000011111111110000111100000000000011111111111111110000111111111111111111111111111111111111111111110000111111111111111100000000000000000000000000000000000
1100000011111111110000111100000000000011111111111111110000111111111111111111111111111111111111111111110000111111111111111100000000000000000000000000000000000
1100000011111111110000000000000000000011111111000011110000111111111111111111111111000011111111111111111111000011111111000000001111111100000000000000000000000
1100000011111111110000000000000000000011111111000011110000111111111111111111111111000011111111111111111111000011111111000000001111111100000000000000000000000
0000000011111111110000000000000000000011111111000011110000111111111111111111111111000011111111111111111111000011111111000000001111111100000000000000000000000
0000000011111111110000000000000000000011111111000011110000111111111111111111111111000011111111111111111111000011111111000000001111111100000000000000000000000
0000000000111111110000000000000000000000001111000011110000000011111111111111111111111111111111111111110000000011111111000011111111111111111111111100000000000
0000000000111111110000000000000000000000001111000011110000000011111111111111111111111111111111111111110000000011111111000011111111111111111111111100000000000
0000001111111111110000000000000000000000001111000011110000000011111111111111111111111111111111111111110000000011111111000011111111111111111111111100000000110
0000001111111111110000000000000000000000001111000011110000000011111111111111111111111111111111111111110000000011111111000011111111111111111111111100000000110
0000001111111111110000000000000000111111111111111111111111111111111111111111111111111111111111111111111111111111111111111111111111111111111111111111110000110
0000001111111111110000000000000000111111111111111111111111111111111111111111111111111111111111111111111111111111111111111111111111111111111111111111110000110
0000001111111111110000000000000000111111111111111111111111111111111111111111111111111111111111111111111111111111111111111111111111111111111111111111110000110
0000001111111111110000000000000000111111111111111111111111111111111111111111111111111111111111111111111111111111111111111111111111111111111111111111110000110
0000000011111111110000000000000000000000000000111111110000111111111111111111111111111111111111111111111111111111111111111111111111111100000000000000000000000
0000000011111111110000000000000000000000000000111111110000111111111111111111111111111111111111111111111111111111111111111111111111111100000000000000000000000
0000000000000011110000000000000000000000000000111111110000111111111111111111111111111111111111111111111111111111111111111111111111111100000000000000000000000
0000000000000011110000000000000000000000000000111111110000111111111111111111111111111111111111111111111111111111111111111111111111111100000000000000000000000
0000000000000000111111000000000000000011110000000011111111111111111111111111111111111111111111111100000000111111111111111111111111000000000000000000000000000
0000000000000000111111000000000000000011110000000011111111111111111111111111111111111111111111111100000000111111111111111111111111000000000000000000000000000
0000000000001111111111000000000000000011110000000011111111111111111111111111111111111111111111111100000000111111111111111111111111000000000000000000000000000
0000000000001111111111000000000000000011110000000011111111111111111111111111111111111111111111111100000000111111111111111111111111000000000000000000000000000
0000000000001111111111111100001111000011111111111111110000111111111111111111111111111111111111111111111111111111111111111111110000000000000000000000000000000
0000000000001111111111111100001111000011111111111111110000111111111111111111111111111111111111111111111111111111111111111111110000000000000000000000000000000
0000000000001111111111111100001111000011111111111111110000111111111111111111111111111111111111111111111111111111111111111111110000000000000000000000000000000
0000000000001111111111111100001111000011111111111111110000111111111111111111111111111111111111111111111111111111111111111111110000000000000000000000000000000
0000000000001111111111000000000000000011110000111111110000111111111111111111111111111111111111111111111111111111111111111111110000000000000000000000000000000
0000000000001111111111000000000000000011110000111111110000111111111111111111111111111111111111111111111111111111111111111111110000000000000000000000000000000
0000000000001111111111000000000000000011110000111111110000111111111111111111111111111111111111111111111111111111111111111111110000000000000000000000000000000
0000000000001111111111000000000000000011110000111111110000111111111111111111111111111111111111111111111111111111111111111111110000000000000000000000000000000
0000000000001111111111000000000000000011111111000011110000111111111111111111111111111111111111111111111111111111111111111111111111000000000000000000000000000
0000000000001111111111000000000000000011111111000011110000111111111111111111111111111111111111111111111111111111111111111111111111000000000000000000000000000
0000000000001111111111000000000000000011111111000011110000111111111111111111111111111111111111111111111111111111111111111111111111000000000000000000000000000
0000000000001111111111000000000000000011111111000011110000111111111111111111111111111111111111111111111111111111111111111111111111000000000000000000000000000
0000000000001111111111000000001111000000001111000011111111111111111111111111111111111111111111111111111111111111111111111111111111000000000000000000000000000
0000000000001111111111000000001111000000001111000011111111111111111111111111111111111111111111111111111111111111111111111111111111000000000000000000000000000
0000000000111111111111000000001111000000001111000011111111111111111111111111111111111111111111111111111111111111111111111111111111000000000000000000000000000
0000000000111111111111000000001111000000001111000011111111111111111111111111111111111111111111111111111111111111111111111111111111000000000000000000000000000
0000000000111111111111000000000000111111111111111111110000111111111111111111111111111111111111111111111111111111111111111111111111000000000000000000000000000
0000000000111111111111000000000000111111111111111111110000111111111111111111111111111111111111111111111111111111111111111111111111000000000000000000000000000
0000000000111111111111000000000000111111111111111111110000111111111111111111111111111111111111111111111111111111111111111111111111000000000000000000000000000
0000000000111111111111000000000000111111111111111111110000111111111111111111111111111111111111111111111111111111111111111111111111000000000000000000000000000
0000000000111111110000000000000000000000000000111111110000000011111111111111111111111111111111111111111111111111111111111111110000000000000000000000000000110
0000000000111111110000000000000000000000000000111111110000000011111111111111111111111111111111111111111111111111111111111111110000000000000000000000000000110
0000000000111111110000000000000000000000000000111111110000000011111111111111111111111111111111111111111111111111111111111111110000000000000000000000000000110
0000000000111111110000000000000000000000000000111111110000000011111111111111111111111111111111111111111111111111111111111111110000000000000000000000000000110
0000000000111111111111000000000000000011110000000000000000000011111111111111111111111111111111000011111111111111111111111111111111000000000000000000001111110
0000000000111111111111000000000000000011110000000000000000000011111111111111111111111111111111000011111111111111111111111111111111000000000000000000001111110
0000000000001111111111000000000000000011110000000000000000000011111111111111111111111111111111000011111111111111111111111111111111000000000000000000001111000
0000000000001111111111000000000000000011110000000000000000000011111111111111111111111111111111000011111111111111111111111111111111000000000000000000001111000
0000000000001111111111000000000000000000000000000000000000000000000000000011111111111111110000000000001111111111111111111111111111000000000000000011111111000
0000000000001111111111000000000000000000000000000000000000000000000000000011111111111111110000000000001111111111111111111111111111000000000000000011111111000
0000000000000000111111000000000000000000000000000000000000000000000000000011111111111111110000000000001111111111111111111111111111000000000000000011110000000
0000000000000000111111000000000000000000000000000000000000000000000000000011111111111111110000000000001111111111111111111111111111000000000000000011110000000
0000000000000000000000001111111111111111111111111100000000000011110000000011111111111111110000000000001111111100000000000000000000000000000000000011110000000
0000000000000000000000001111111111111111111111111100000000000011110000000011111111111111110000000000001111111100000000000000000000000000000000000011110000000
0000000000000000000000000000111111111111111111111100000000000011110000000011111111111111110000000000001111111100000000000000000000000000000000000011110000000
0000000000000000000000000000111111111111111111111100000000000011110000000011111111111111110000000000001111111100000000000000000000000000000000000011110000000
0000000000000000000000000000111111111111111111111111110000000000001111000000001111111111110000000000000000111100000000000000000000000000000000111111000000000
0000000000000000000000000000111111111111111111111111110000000000001111000000001111111111110000000000000000111100000000000000000000000000000000111111000000000
0000000000000000000000000000000000001111111111111111110000000000001111000000001111111111110000000000000000111100000000000000000000000000000000111100000000000
0000000000000000000000000000000000001111111111111111110000000000001111000000001111111111110000000000000000111100000000000000000000000000000000111100000000000
0000000000000000000000000000000000000000001111110011110000000000000000000011111111111111110000000000000000000011110000000011111111111111111111000000000000000
0000000000000000000000000000000000000000001111110011110000000000000000000011111111111111110000000000000000000011110000000011111111111111111111000000000000000
0000000000000000000000000000000000000000000000000011110000000000000000000011111111111111110000000000000000000011110000000011111111111111001100000000000000000
0000000000000000000000000000000000000000000000000011110000000000000000000011111111111111110000000000000000000011110000000011111111111111001100000000000000000
0000000000000000000000000000000000000000000000000011111111000000000000111111111111111111111111111111111111111111111111111111111100000000000000000000000000000
0000000000000000000000000000000000000000000000000011111111000000000000111111111111111111111111111111111111111111111111111111111100000000000000000000000000000
0000000000000000000000000000000000000000000000000000001111000000000000111111111111111111110000000000111111111111110000001100000000000000000000000000000000000
0000000000000000000000000000000000000000000000000000001111000000000000111111111111111111110000000000111111111111110000001100000000000000000000000000000000000
0000000000000000000000000000000000000000000000000000000011111111111111111111111111111111110000000000001100000000000000000000000000000000000000000000000000000
0000000000000000000000000000000000000000000000000000000011111111111111111111111111111111110000000000001100000000000000000000000000000000000000000000000000000
0000000000000000000000000000000000000000000000000000000000000000001111111111111111111111110000000000000000000000000000000000000000000000000000000000000000000
0000000000000000000000000000000000000000000000000000000000000000001111111111111111111111110000000000000000000000000000000000000000000000000000000000000000000
0000000000000000000000000000000000000000000000000000000000000000001111111111111111111111000000000000000000000000000000000000000000000000000000000000000000000
0000000000000000000000000000000000000000000000000000000000000000001111111111111111111111000000000000000000000000000000000000000000000000000000000000000000000
0000000000000000000000000000000000000000000000000000000000000000001111111111111111111111000000000000000000000000000000000000000000000000000000000000000000000
0000000000000000000000000000000000000000000000000000000000000000001111111111111111111111000000000000000000000000000000000000000000000000000000000000000000000
0000000000000000000000000000000000000000000000000000000000000000001111111111111111111100000000000000000000000000000000000000000000000000000000000000000000000
0000000000000000000000000000000000000000000000000000000000000000001111111111111111111100000000000000000000000000000000000000000000000000000000000000000000000
0000000000000000000000000000000000000000000000000000000000000000001111111111111111111100000000000000000000000000000000000000000000000000000000000000000000000
0000000000000000000000000000000000000000000000000000000000000000001111111111111111111100000000000000000000000000000000000000000000000000000000000000000000000
0000000000000000000000000000000000000000000000000000000000000000001111111111111111110000000000000000000000000000000000000000000000000000000000000000000000000
0000000000000000000000000000000000000000000000000000000000000000001111111111111111110000000000000000000000000000000000000000000000000000000000000000000000000
0000000000000000000000000000000000000000000000000000000000000000001111111111111111000000000000000000000000000000000000000000000000000000000000000000000000000
0000000000000000000000000000000000000000000000000000000000000000001111111111111111000000000000000000000000000000000000000000000000000000000000000000000000000
0000000000000000000000000000000000000000000000000000000000000000000011111111111100000000000000000000000000000000000000000000000000000000000000000000000000000
0000000000000000000000000000000000000000000000000000000000000000000011111111111100000000000000000000000000000000000000000000000000000000000000000000000000000
