1
185
-39
114
00000000000000000000000000000000000000000000000000000000000000000000000000000000000000000000000000000000000000000000000000000000000000000000000000000000000000000000000000000000000000000
00000000000000000000000000000000000000000000000000000000000000000000000000011001100110011001100110000000000000000000000000000000000000000000000000000000000000000000000000000000000000000
00000000000000000000000000000000000000000000000000000000000000000000000111111111111111111111111100000000000000000000000000000000000000000000000000000000000000000000000000000000000000000
00000000000000000000000000000000000000000000000000000000000000000000001111111111111111111111111100000000000000000000000000000000000000000000000000000000000000000000000000000000000000000
00000000000000000000000000000000000000000000000000000000000000000000011111111111111111111111111100000000000000000000000000000000000000000000000000000000000000000000000000000000000000000
00000000000000000000000000000000000000000000000000000000000000001000111111111111111111111111111110000000000000000000000000000000000000000000000000000000000000000000000000000000000000000
00000000000000000000000000000000000000000000000000000000000000011111111111111111111111111111111111111111111000000000000000000000000000000000000000000000000000000000000000000000000000000
00000000000000000000000000000000000000000000000000000000000000011111111111111111111111111111111111111111111100000000000000000000000000000000000000000000000000000000000000000000000000000
00000000000000000000000000000000000000000000000000000000000111111111111111111111111111111111111111111111111100000000000000000000000000000000000000000000000000000000000000000000000000000
00000000000000000000000000000000000000000000000000000000000111111111111111111111111111111111111111111111111110000000000000000000000000000000000000000000000000000000000000000000000000000
00000000000000000000000000000000000000000000000000000001111111111111111111111111111110001111111111111111111100000000000000000000000000000000000000000000000000000000000000000000000000000
00000000000000000000000000000000000000000000000000000001111111111111111111111111111100001111111111111111111000000000000000000000000000000000000000000011111111111100000000000000000000000
00000000000000000000000000000000000000000000000000111111111111111111111111111111111100001111111111111111110000000000000000000000000000000000000000001111111111111100000000000000000000000
00000000000000000000000000000000000000000000000001111111111111111111111111111111111110011111111111111111100000000000000000000000000000000000000111111111111111111000000000000000000000000
00000000000000000000000000000000000000000000111111111111111111111111111111111111111111111111111111111111000000000000000000000000000000000011111111111111111111110000000000000000000000000
00000000000000000000000000000000000000000001111111111111111111111111111111111111111111111111111111111111000000000010000000000000000111111111111111111111111111110000000000000000000000000
00000000000000000000000000000000000000000011111111111111111111111111111111111111111111111111111111111111000000000111000000000000001111111111111111111111111111110000000000000000000000000
00000000000000000000000000000000000000000111111111111111111111111111111111111111111111111111111111111111000000001111100011111111111111111111111111111111111111111001000000000000000000000
00000000000000000000000000000000000000011111111111111111111111111111111111111111111111111111111111111111111111111111111111111111111111111111111111111111111111111111000000000000000000000
00000000000000000000000000000000000000111111111111111111111111111111111111111111111111111111111111111111111111111111111111111111111111111111111111111111111111111111000000000000000000000
00000000000000000000000000000000000001111111111111111111111111111111111111111111111111111111111111111111111111111111111111111111111111111111111111111111111111111111000000000000000000000
00000000000000000000000000000000000011111111111111111111111111111111111111111111111111111111111111111111111111111111111111111111111111111111111111111111111111111111100000000000000000000
00000000000000000000000000000000000111111111100111111111111111111111111111111111111111111111111111111111111111111111111111111111111111111111111111111111111111111111100000000000000000000
00000000000000000000000000000000001111111110000100011111111111111111111111111111111111111111111111111111111111111111111111111111111111111111111111100000011111111111100000000000000000000
00000000000000000000000000000000011111111100000000011111111111111111111111111111111111111111111111111111111111111111111111111111111111111111111111100000011111111111100000000000000000000
00000000000000000000000000000000111111111000000000011111111111111111111111111111111111111111111111111111111111111111111111111111111111111111111110000000000111111111111000000000000000000
00000000000000000000000000000001111111110000000000111111111111111111111111111111111111111111111111111111111111111111111111111111111111111111111110000000000111111111111000000000000000000
00000000000000000000000000000111111111110000000001111111111111111111111100000000000111111111111111111111111111111111111111111111111111111111111110000000000111111111111000000000000000000
00000000000000000000000000001111111111110000000011111111111111111111111100000000000111111111111111111111111111111111111111111111111111111111111110000000000111111111111000000000000000000
00000000000000000000000000011111111111111000000111111111111111111111000000000000000000000111111111111111000000011111111111111111111110000011111110000000000111111111111000000000000000000
00000000000000000000000000111111111111111111111111111111111111111111000000000000000000000111111111111111000000011111111111111111111110000000000000000100000111111111111000000000000000000
00000000000000000000000001111111111111111111111111111111110000000000000000000000000000000000000001111000000000000011100000000000000000000000000000000100000000011111111000000000000000000
00000000000000000000000011111111111111111111111111111111110000000000000000000000000000000000000000000000000000000011100000000000000000000000000000011100000000011111111000000000000000000
00000000000000000000000111111111111111111111111111111100000000000000000000000000000000000000000000000000000000000011100000000000000000000000000000011100000000011111111000000000000000000
00000000000000000000001111111111111111111111111111111000000000000000000000000000000000000000000000000000000000000011100000000000000000000000000000011111000000011111111000000000000000000
00000000000000000000011111111111111111111111111111111000000000000000000000000000000000000000000000000000000000000111111000000000000000000000000000011111000000000111111000000000000000000
00000000000000000001111111111111111111111111111111111000000000000000000000000000000000000000000000000000000000000111111000000000000000000000000011111111110000000111111000000000000000000
00000000000000000001111111111111111111111111111111100000000000000000000000000000000000000000000000000000000000001111110000000000000000000000000011111111110000000111111000000000000000000
00000000000000000011111111111111111111111111111111100000000000000000000000000000000000000000000000000000000000001111100000000000000000000000111111111111110000000111111000000000000000000
00000000000000000111111111111111111111111111111110000000000000000000000000000000000000000000000000000000000000000111000000000000000000000000111111111111110000000111110000000000000000000
00000000000000001111111111111111111111111111111110000000000000000000000000000000000000000000000000000000000000000000000000000000000000000000111111111111111100000111110000000000000000000
00000000000000001111111111111111111111111111111000000000000000000000000000000000000000000000000000000000000000000000000000000000000000000000111111111111111100000111110000000000000000000
00000000000000011111111111111111111111111111111000000000000000000000000000000000000000000000000000000000000000000000000000000000000000000000111111111111111100000111110000000000000000000
00000000000000111111111111111111111111111111000000000000000000000000000000000000000000000000000000000000000000000000000000000000000000000000111111111111111100000111110000000000000000000
00000000000000111111111111111111111111111100000000000000000000000000000000000000000000000000000000000000000000000000000000000000000000000000011111111111111111111111111100000000000000000
00000000000000111111111111111111111111111000000000000000000000000000000000000000000000000000000000000000000000000000000000000000000000000000001111111111111111111111111100000000000000000
00000000000000111111111111111111111111110000000000000000000000000000000000000000000000000000000000000000000000000000000000000000000000000000000111111111111111111111111100000000000000000
00000000000001111111111111111111111111110000000000000000000000000000000000000000000000000000000000000000000000000000000000000000000000000000000111111111111111111111110000000000000000000
00000000000011111111111111111111111111110000000000000000000000000000000000000000000000000000000000000000000000000000000000000000000000000000000011111111111111111111110000000000000000000
00000000000011111111111111111111111111110000000000000000000000000000000000000000000000000000000000000000000000000000000000000000000000000000000001111111111111111111000000000000000000000
00000000011111111111111111111111111111111000000000000000000000000000000000000000000000000000000000000000000000000000000000000000000000000000000000111111111111111111000000000000000000000
00000000011111111111111111111111111111111000000000000000000000000000000000000000000000000000000000000000000000000000000000000000000000000001000000111111111111111100000001111111100000000
00000000111111111111111111111111111111111000000000000000000000000000000000000000000000000000000000000000000000000000000000000000000000000000000000001111111111111100000001111111100000000
00000001111111111111111111111111111111111000000000000000000000000000000000000000000000000000000000000000000000000000000000000000000000000000000000000000000111111100000001111111100000000
00000001111111111111111111111111111111111000000000000000000000000000000000000000111000000000000000000000000000000000000000000000000000000000000000000000000111111100000001111111100000000
00000000111111111111111111111111111111111000000000000000000000000000000000000001111111000000000000000000000000000000000000000000000000000000000000000000000001111110000001111111111111100
00000000011111111111111111111111111111111000000000000000000000000000000000000001111111100000000000000000000011000000000000000000000000000000000000000000000001111110000001111111111111100
00000000001111111111111111111111111111111000000000000000000000000000000000000011111111110000000000000000000111000000000000000000000000000000000000000000000001111110000001111111111111100
00000000001111111111111111111111111111111000000000000000000000000000001100001111111111111000000000000000000111100000000000000000000000000000000000000000000001111110000001111111111111110
00000000001111111111100111111111111111111000000000000000000000000000001111111111111111111111100000000000001111110000000000000000000000000000000000000000000001111110000111111111111111110
00000000001111111110000111111111111111111000000000000000000000000000001111111111111111111111110000000000011111111000000000000000000000000000000000000000000001111110000111111111111111110
00000000011111111100001111111111111111111000000000000000000000000000001111111111111111111111111000000000111111111100000000000000000000000000000000000000000001111111111111111111111111110
00000000111111111000001111111111111111111000000000000000000000000000001111111111111111111111111100000001111111111110000000000000000000000000000000000000000011111111111111111111111111110
00000000111111110000011111111111111111111000000000000000000000000000001111111111111111111111111111111111111111111111000000000000000000000000000000000000011111111111111111111111111111110
00000000111111110000111111111111111111111000000000000000000000000000001111111111111111111111111111111111111111111111111000000000000000000000000000000000011111111111111111111111111111110
00000000111111111001111111111111111111111000000000000000000000000000001111111111111111111111111111111111111111111111111100000000000000000000000000000001111111111111111111111111111111110
00000000111111111111111111111111111111111000000000000000000000000000011111111111111111111111111111111111111111111111111100000000000000000000000000000001111111111111111111111111111111110
00000001111111111111111111111111111111111000000000000000000000000000011111111111111111111111111111110000000011111111111100000000000000000000000000000000011111111111111111111111111111110
00000011111111111111111111111111111111111000000000000000000000000000011111111111111111111111111111100000000011111111111100000000000000000000000000000000011111111111111111111111111111110
00000011111111111111111111111111111111111000000000000000000000000000011111111111111111111111111111000000000011111111111100000000000000000000111000000000011111111111111111111111111111110
00000011111111111111111111111111111111000000000000000000000000000000011111111111111111111111111110000000000011111111111000000000000000000000111000000000011111111111111111111111111111110
00000011111111111111111111111111111110000000000000000000000000000000011111111111111111111111100000000000000011111111111000000000000000000000111110000000011111111111111111111111111111110
00000011111111111111111111111111111100000000000000000000000000000000111111111111111111111111000000000000000011111111111000000000000000000000111110000000011111111111111111111111111111100
00000011111111111111111111111111111100000000000000000000000000000001111111111111111111111110000000000000000011111111111000000000000000000000111111111111111111111111111111111111111111000
00000011111111111111111111111111111100000000000000000000000000000011111111111111111111111110000000000000000011111111111100000000000000000001111111111111111111111111111111111111111110000
00000011111111111111111111111111111100000000000000000000000000000111111111111111111111111110000000000000000011111111111111000000000000000011111111111111111111111111111111111111111110000
00000011111111111111111111111111111100000000000000000000000000000111111111111111111111111110000000000000000011111111111111100000000000000111111111111111111111111111111111111111111100000
00000011111111111111111111111111111111000000000000000011000000000111111111111111111111111110000000000000000111111111111111111000000000000111111111111111111111111111111111111111111000000
00000011111111111111111111111111111111100000000000000011111100001111111111111111111111111110000000000000001111111111111111111111111111111111111111111111111111111111111111111111110000000
00000011111111111111111111111111111111111111111111111111111111111111111111111111111111111110000000000000001111111111111111111111111111111111111111111111111111111111000111111111100000000
00000011111111111111111111111111111111111111111111111111111111111111111111111111111111111110000000000000001111111111111111111111111111111111111111111111111111111110000111111111100000000
00000011111111111111111111111111111111111111111111111111111111111111111111111111111111111110000000000000011111111111111111111111111111111111111110000000011111111100000111111111100000000
00000011111111111111111111111111111111111111111111111111111111111111111111111111111111111110000000000000011111111111111111111111111111111111111110000000011111111000001111111111100000000
00000011111111111111111111111111111111111111111111111111111111111111111111111111111111111111111111111111111111111111111111111111100000000000000000000000011111110000011111111111000000000
00000001111111111111111111111111111111111111111111111111111111100011111111111111111111111111111111111111111111111111111111111111000000000000000000000000011111110000111111111110000000000
00000001111111111111111111111111111111111111111111111111111111000011111111111111111111111111111111111111111111111111111111111110000000000000000000000001111111110001111111111000000000000
00000001111111111111111111111111111111111111111111111111111110000011111111111111111111111111111111111111111111111111111111111100000000000000000000000001111111111111111111111000000000000
00000001111111111111111111111111111111111111000000000000000000000011111111111111111111111111111111111111111111100000011111111000000000000000000000000001111111111111111111110000000000000
00000001111111111111111111111111111111111110000000000000000000000011111111111111111111111111111111111111111111000000011111110000000000000000000000000001111111111111111111000000000000000
00000011111111111111111111111111111111111000000000000000000000000011111111111111111111111111111111111111111111000000011111100000000000000000000000000001111111111111111110000000000000000
00000011111111111111111111111111111111110000000000000000000000000111111111111111111111111111111111111111111111000000011111100000000000000000000000000001111111111111111100000000000000000
00000011111111111111111111111111111111110000000000000000000000000111111111111111111111111111111111110011100111000000011111000000000000000000000000000001111111111111111100000000000000000
00000111111111111111111111111111111111110000000000000000000000000111111111111111111111111111111111000000000111000000111111000000000000000000000000000001111111111111111100000000000000000
00000111111111111111111111111111111111110000000000000000000000000111111111111111111111111111111110000000000111000001111111000000000000000000000000000111111111111111111100000000000000000
00000111111111111111111111111111111111110000000000000000000000000011111111111111111111111111111100000000001111111111111111000000000000000000000000000111111111111111111100000000000000000
00001111111111111111111111111111111111110000000000000000000000000001111111111111111111111111111000000000011111111111111111000000000000000000000000000011111111111111111100000000000000000
00001111111111111111111111111111111111110000000000000000000000000001111111111111111111111110000000000000011111111111111111100000000000000000000000000011111111111111111000000000000000000
00011111111111111111111111111111111111111000000000000000000000000001111111111111111111111100000000000000111111111111111111110000000000000000000000000011111111111111110000000000000000000
00011111111111111111111111111111111111111100000000000000000000000001111111111111111111111100000000000000111111111111111111111000000000000000000000000011111111111111110000000000000000000
00111111111111111111111111111111111111111100000000000000000000000001111111111111111111111100000000000000011111111111111111111100000000000000000000000111111111111111110000000000000000000
00111111111111111111111111111111111111111100000000000000000000000001111111111111111111111100000000000000011111111111111111111000000000000000000000001111111111111111110000000000000000000
01111111111111111111111111111111111111111100000000000000000000000001111111111111111111111100000000000000000001111111111111111000000000000000001100011111111111111111110000000000000000000
01111111111111111111111111111111111111111100000000000000000000000001111111111111111111111100000000000000000001111111111111110000000000000000001111111111111111111111100000000000000000000
11111111111111111111111111111111111111111100000000000000000000000001111111111111111111111100000000000000000001110011111111100000000000000000000000011111111111111111000000000000000000000
11111111111111111111000000111111111111111100000000000000000000000001111111100000001111111100000000000000000001100001111111000000000000000000000000011111111111111111000000000000000000000
11111111111111111100000000111111111111111100000000000000000000000001111111000000000111111100000000000000000000000000111100000000000000000000000000000001111111111111000000000000000000000
01111111111111110000000000011111111111111100000000000000000000000001111110000000000111111100000000000000000000000000111000000000000000000000000000000001111111111111000000000000000000000
00001111111111100000000000000011111111111100000000000000000000000000000000000000000111111100000000000000000000000000000000000000000000000001100000000001111111111111000000000000000000000
00000000000000000000000000000011111111111100000000000000000000000000000000000000000111111100000000000000000000000000000000000000000000000001000000000001111111111110000000000000000000000
00000000000000000000000000000011111111111000000000000000000000000000000000000000000111111100000000000000000000000000000000000000000000000000000000000001111111111100000000000000000000000
00000000000000000000000000000011111111110000000000000000000000000000000000000000000111111100000000000000000000000000000000000000000000000000000000000001111111111100000000000000000000000
00000000000000000000000000000011111111110000000000000000000000000000000000000000000111111100000000000000000000000000000000000000000000000000000000000001111111111100000000000000000000000
00000000000000000000000000000011111111111000000000000000000000000000000000000000000111111100000000000000000000000000000000000000000000000000000000000001111111111000000000000000000000000
00000000000000000000000000000011111111111100000000000000000000000000000000000000000111111100000000000000000000000000000000000000000000000000000000000001111111100000000000000000000000000
00000000000000000000000000000011111111111100000000000000000000000000000000000000000111111100000000000000000000000000000000000000000000000000000000000111111100000000000000000000000000000
00000000000000000000000000000111111111111100000000000000000000000000000000000000000111111100000000000000000000000000000000000000000000000000000000000111110000000000000000000000000000000
00000000000000000000000000001111111111111100000000000000000000000000000000000000000111111100000000000000000000000000000000000000000000000000000001111111100000000000000000000000000000000
00000000000000000000000000011111111111111100000000000000000000000000000000000000000111111100000000000000000000000000000000000000000000000000000001111111000000000000000000000000000000000
00000000000000000000000000111111111111111110000000000000000000000000000000000000001111111100000000000000000000000000000000000000000000000000000011111111000000000000000000000000000000000
00000000000000000000000000111111111111111110000000000000000000000000000000000000011111111100000000000000000000000000000000000000000000000000000111111111000000000000000000000000000000000
00000000000000000000000000111111111111111110000000000000000000000000000000000000111111111100000000000000000000000000000000000000000000000000001111111111100000000000000000000000000000000
00000000000000000000000001111111111111111110000000000000000000000000000000000001111111111100000000000000000000000000000000000000000000000000001111111111000000000000000000000000000000000
00000000000000000000000011111111111111111110000000000000000000000000000000000011111111111100000000000000000000000000000000000000000000000000011111111110000000000000000000000000000000000
00000000000000000000000011111111111111111100000000000000000000000000000000000011111111111100000000000000000000000000000000000000000000000000111111111100000000000000000000000000000000000
00000000000000000000000011100011111111111000000000000000000000000000000000000000011111111100000000000000000000000000000000000000000000000001111111111000000000000000000000000000000000000
00000000000000000000000001000011111111110000000000000000000000000000000000000000011111111100000000000000000000000000000000000000000000000011111111110000000000000000000000000000000000000
00000000000000000000000000000011111111110000000000000000000000000000000000000000011111111100000000000000000000000000000000000000000000000111111111110000000000000000000000000000000000000
00000000000000000000000000000111111111110000000000000000000000000000000000000000011111111100000000000000000000000000000000000000000000000111111111110000000000000000000000000000000000000
00000000000000000000000000001111111111111100000000000000000000010000000000000000011111111100000000000000000000000000000000000000000000000111111111111000000000000000000000000000000000000
00000000000000000000000000011111111111111111100000000000000000010000000000000000011111111100000000000000000000000000000000000000000000000111111111110000000000000000000000000000000000000
00000000000000000000000000111111111111111111100000000000000001110000000000000000011111111100000000000000000000000000000000000000000000000111111111110000000000000000000000000000000000000
00000000000000000000000001111111111111111111100000000000000001110000000000000000011111111100000000000000000000000000000000000000000000000111111111111000000000000000000000000000000000000
00000000000000000000000001111111111111111111100000000000011111110000000000000000011111111100000000000000000000000001111110000000000000000111111111111000000000000000000000000000000000000
00000000000000000000000011111111111111111111100000000000011111110000000000000000011111111100000000000000000000000001111110000000000000000111111111110000000000000000000000000000000000000
00000000000000000000000011111111111111111111111111111111111111110000000000000000111111111111111110000000000000000111111110000000000001111111111111100000000000000000000000000000000000000
00000000000000000000000001111111111111111111111111111111111111110000001111111111111111111111111110000000000000000111111110000000000001111111111111100000000000000000000000000000000000000
00000000000000000000000000111111111111111111111111111111111111110000011111111111111111111111111111100000000000011111111111111111111111111111111111100000000000000000000000000000000000000
00000000000000000000000000011111111111111111111111111111111111111111111111111111111111111111111111100000000000011111111111111111111111111111111100000000000000000000000000000000000000000
00000000000000000000000000000011111111111111111111111111111111111111111111111111111111111111111111111000000000011111111111111111111111111111111000000000000000000000000000000000000000000
00000000000000000000000000000001111111111111111111111111111111111111111111111111111111111111111111111000000000011111111111111111111111111111110000000000000000000000000000000000000000000
00000000000000000000000000000001111111111111111111111111111111111111111111111111111111111111111111111111111111111111111111111111111111111111100000000000000000000000000000000000000000000
00000000000000000000000000000001111111111111111111111111111111111111111111111111111111111111111111111111111111111111111111111111111111111111000000000000000000000000000000000000000000000
00000000000000000000000000000000111111111111111111111111111111111100000000000011111111111111111111111111111111111111111111111111111111111110000000000000000000000000000000000000000000000
00000000000000000000000000000000111111111111100111111111111111100000000000000000000000011111111111111111111111111111111111111111111111111100000000000000000000000000000000000000000000000
00000000000000000000000000000000000000000000000001111111111111000000000000000000000000000000000000011111111111111111111111111111111111111000000000000000000000000000000000000000000000000
00000000000000000000000000000000000000000000000001111111111110000000000000000000000000000000000000011111111111111111111111111111111100010000000000000000000000000000000000000000000000000
00000000000000000000000000000000000000000000000001111111111000000000000000000000000000000000000000000000001111111111111111111111111000000000000000000000000000000000000000000000000000000
00000000000000000000000000000000000000000000000000111111110000000000000000000000000000000000000000000000000111111111111111111111110000000000000000000000000000000000000000000000000000000
00000000000000000000000000000000000000000000000000000000000000000000000000000000000000000000000000000000000011111111111111111111100000000000000000000000000000000000000000000000000000000
00000000000000000000000000000000000000000000000000000000000000000000000000000000000000000000000000000000000001111111111111111111000000000000000000000000000000000000000000000000000000000
00000000000000000000000000000000000000000000000000000000000000000000000000000000000000000000000000000000000000111111111100111111000000000000000000000000000000000000000000000000000000000
00000000000000000000000000000000000000000000000000000000000000000000000000000000000000000000000000000000000000011111110000011111000000000000000000000000000000000000000000000000000000000
00000000000000000000000000000000000000000000000000000000000000000000000000000000000000000000000000000000000000011111000000011111000000000000000000000000000000000000000000000000000000000
00000000000000000000000000000000000000000000000000000000000000000000000000000000000000000000000000000000000000011110000000011000000000000000000000000000000000000000000000000000000000000
