-55
90
-34
113
00000000000000000000000000000000000000000000000000000000000000000000000000000000000000000000000000000000000000000000000000000000000000000000000000
00000000000000000000000000000000000000000000000000000111110000000000000000000000000000000000000000000000000000000000000000000000000000000000000000
00000000000000000000000000000000000000000000000000001111111000000000000000000000000000000000000000000000000000000000000000000000000000000000000000
00000000000000000000000000000000000000000000000000011111111000000000000000000000000000000000000000000000000000000000000000000000000000000000000000
00000000000000000000000000000000000000000000000000011111111000000000000000000000000000000000000000000000000000000000000000000000000000000000000000
00000000000000000000000000000000000000000000000000111111111100000000000000000000000000000000000000000000000000000000000000000000000000000000000000
00000000000000000000000000000000000000000000000001111111111100000000000000000000000000000000000000000000000000000000000000000000000000000000000000
00000000000000000000000000000000000000000000000001111111111100000000000000000000000000000000000000000000000000000000000000000000000000000000000000
00000000011111111111111110000000000000000000000111111111111000000000000000000000000000000000000000000000000000000000000000000000000000000000000000
00000000011111111111111110000000000000000000001111111111111000000000000000000000000000000000000000000000000000000000000000000000000000000000000000
00000000111111111111111111111110000000000000001111111111111000000000000000000000000000000000000000000000000000000000000000000000000000000000000000
00000000111111111111111111111110000000000000001111111111111000000000000000000000000000000000000000000000000000000000000000000000000000000000000000
00000000111111111111111111111111111110000000001111111111111000000000000000000000000000000000000000000000000000000000000111111111111000000000000000
00000000111111111111111111111111111110000000011111111111111000000000000000000000000000000000000000000000000000000000000111111111111000000000000000
00001111111111111111111111111111111110000000111111111111111000000000000000000000000000000000111000000000000000000000011111111111111000000000000000
00001111111111111111111111111111111110000000111111111111111000000000000000000000000000000000111000000000000000000000011111111111111000000000000000
00001111111111111111111111111111111110000000111111111111111000000000000000000000000000000000111000000000000000000001111111111111111000000000000000
00001111111111111111111111111111111110000001111111111111111000000000000000000000000000000001111000000000000000000001111111111111111000000000000000
00111111111111111111111111111111111111111111111111111111111000000000000000011111111111111111111000000000000000000111111111111111111111110000000000
00111111111111111111111111111111111111111111111111111111111000000000000000011111111111111111111000000000000000000111111111111111111111111000000000
00111111111111111111111111111111111111111111111111111111111000000000000000011111111111111111111000000000000000000111111111111111111111111000000000
00111111111111111111111111111111111111111111111111111111111000000000000000011111111111111111111000000000000000000111111111111111111111111111000000
11111111111111111111111111111111111111111111111111111111111000000000000000011111111111111111111110000000000000001111111111111111111111111111000000
11111111111111111111111111111111111000011111111111111111111000000000000000111111111111111111111110000000000000001111111111111111111111111111000000
11111111111111111111111111111111111000001111111111111111111110000000000001111111111111111111111111100000000000111111111111111111111111100000000000
11111111111111111111111111111111111000000001111111111111111110000000000001111111111111111111111111100000000000111111111111111111111111100000000000
11111111111111111111111111111111111000000000111111111111111111111111111111111111111111111111111111111111111111111111111111111111111000000000000000
11111111111111111111111111111111111000000000111111111111111111111111111111111111111111111111111111111111111111111111111111111111111000000000000000
11111111111111111111111111111111111000000000111111111111111111111111111111111111111111111111111111111111111111111111111111111111111000000000000000
11111111111111111111111111111111111000000000000000011111111111111111111111111111111111111111111111111111111111111111111111111111111000000000000000
11111111111111111111111111111111111000000000000000011111111111111111111111111111111111111111111111111111111111111111111111111111111000000000000000
00111111111111111111111111111111111000000000000000011111111111100000000000111111111111111111111111111111111111111111111111111111111000000000000000
00111111111111111111111111111111111000000000000000011111111111100000000000001111111111111111111111111111111111111111100001111111111000000000000000
00111111111111111111000110111111111000000000000000011111111111100000000000000001111111111111111111111111111111111110000001111111111000000000000000
00111111111111111110000000001111111000000000000000011111100000000000000000000000111111111111111111111110000000111110000001111111111000000000000000
00111111111111111100000000001111111000000000000000011111100000000000000000000000011111111111111111100000000000111110000001111111111000000000000000
00111111111111111000000000000011111000000000000001111111100000000000000000000000001111111111111111100000000000111110000001111111111000000000000000
00001111111111110000000000000011111000000000000001111111100000000000000000000000001111111111111110000000000000111110000001111111111000000000000000
00001111111000000000000000000011111000000000000111111000000000000000000000000000001111111111111110000000000000111110000000011111111000000000000000
00001111110000000000000000000011111000000000000111111000000000000000000000000000001111111111111110000000000000111110000000011111111000000000000000
00001111100000000000000000000011111111111111111111111000000000000000000000000000001111111110000000000000000000111110000000011111111000000000000000
00001111000000000000000000000011111111111111111111111000000000000000000000000000001111111000000000000000000000111110000000011111111000000000000000
00001110000000000000000000000011111111111111111111100000000000000000000000000000001111110000000000000000000000111110000001111111111000000000000000
00001100000000000000000000001111111111111111111111100000000000000000000000000000001111110000000000000000000000111110000001111111111000000000000000
00001000000000000000000000001111111111111111111110000000000000000000000000000000001111110000000000000000000000111110000001111111111000000000000000
00000000000000000000000000111111111111111111111110000000000000000000000000000000001111110000000000000000000000111110000001111111111000000000000000
00000000000000000000000000111111111111111111111110000000000000000000000000000000001111110000000000000000000000111110000001111111111000000000000000
00000000000000000000000011111111111111111111111110000000000000000000000000000000001111110000000000000000000000111110000001111111111000000000000000
00000000000000000000000011111111111111111111111110000000000000000000000000000000001111110000000000000000000000111110000001111111111000000000000000
00000000000000000000001111111111111111111111111110000000000000000000000000000000001111110000000000000000000000111110000001111111111000000000000000
00000000000000000000001111111111111111111111111110000000000000000000000000000000001111110000000000000000000000111110000001111111100000000000000000
00000000000000000000001111111111111111111111111110000000000000000000000000000000001111110000000000000000000000111110000001111111100000000000000000
00000000000000000000001111111111111111111111111110000000000000000000000000000011111111100000000000000111111111111111111111111111100000000000000000
00000000000000000000001111111111111111111111111110000000000000000000000000000011111111000000000000000111111111111111111111111111100000000000000000
00000000000000000000001111111111111111111111111110000000000000000000000000000011111110000000000000011111111111111111111111111111111000000000000000
00000000000000000000001111111111111111111111111110000000000000000000000000000111111100000000000000011111111111111111111111111111111000000000000000
00000000000000000000001111111111111111111111111110000000000000000000000000111111111100000000000001111111111111111111111111111111111110000000000000
00000000000000000000001111111111111111111111111110000000000000000000000001111111111110000000000001111111111111111111111111111111111110000000000000
00000000000000000000001111111111111111111111111110000000000000000000000011111111111111000000000001111111111111111111111111111111111111100000000000
00000000000000000000111111111111111111111111111110000000000000000000000111111111111111100000000001111111111111111111111111111111111111100000000000
00000000000000000000111111111111111111111111111111100000000000000000001111111111111111111110000111111111111111111111111111111111111111100000000000
00000000000000000000111111111111111111111111111111100000000000000000011111111111111111111110000111111111111111111111111111111111111111100000000000
00000000000000000000111111111111111111111111111111111000000000000000111111111111111111111111111111111111111111111111111111111111111111100000000000
00000000000000000000111111111111111111111111111111111000000000000001111111111111111111111111111111111111111111111111111111111111111111100000000000
00000000000000000000111111111111111111111111111111111111111111111111111111111111111111111111111111111111111111111111111111111111111111111000000000
00000000000000000000111111111111111111111111111111111111111111111111111111111111111111111111111111111111111111111111111111111111111111111000000000
00000000000000000000111111111111111111111111111111111111111111111111111111111111111111100001111111111111111111111111111111111111111111111000000000
00000000000000000000111111111111111111111111111111111111111111111111111111111111111111100001111111111111111111111111111111111111111111111000000000
00000000000000000000111111111111111111111111111111111111111111111111111111111111111110000001111111111111111111111111111111111111111111111000000000
00000000000000000000001111111111111111111111111111111000000000001111111111111111111110000001111111111111111110000000111111111111111111111000000000
00000000000000000000001111111111111111111111100000000000000000001111111111111111111000000111111111111111111110000000111111111111111111111000000000
00000000000000000000000011111111111111111111100000000000000000001111111111111111111000000111111111111111111110000000111111111111111111111000000000
00000000000000000000000011111111111111111110000000000000000000001111111111111111111000001111111111111111111000000000111111111111111111111000000000
00000000000000000000000000111111111111111110000000000000000000001111111111111111111000001111111111111111111000000000111111111111111111111000000000
00000000000000000000000000111111111111111000000000000000000000001111111111111111111000001111111111111111111000000000111111111111111111111000000000
00000000000000000000000000001111111111100000000000000000000000001111111111111111111000001111100000000000000000000000111111111111111111100000000000
00000000000000000000000000001111111111100000000000000000000000001111111111111110000000001111100000000000000000000000001111111111111111100000000000
00000000000000000000000000000000111111100000000000000000000000000011111111111110000000001111100000000000000000000000001111111111111110000000000000
00000000000000000000000000000000111000000000000000000000000000000011111111111110000000001111100000000000000000000000001111111111111110000000000000
00000000000000000000000000000000111000000000000000000000000000000000001111111110000000001111100000000000000000000000001111111111111000000000000000
00000000000000000000000000000000111000000000000000000000000000000000001111111110000000001111100000000000000000111000001111111111111000000000000000
00000000000000000000000000000000111000000000000000000000000000000000001111111110000000001111100000000000000000111000001111111111111000000000000000
00000000000000000000000000000000111000000000000000000000000000000000001111111110000000001111100001111111111111111111111111111111111000000000000000
00000000000000000000000000000000111000000000000000000000000000000000001111111110000000001111100001111111111111111111111111111111111000000000000000
00000000000000000000000000000000111000000000000000000000000000000000001111111111111111111111111111111111111111111111111111111111111110000000000000
00000000000000000000000000000000111000000000000000000000000000000000001111111111111111111111111111111111111111111111111111111111111110000000000000
00000000000000000000000000000000111000000000000000000000000000000000001111111111111111111111111111111111111111111111111111111111111111100000000000
00000000000000000000000000000000111000000000000000000000000000000000001111111111111111111111111111111111111111111111111111111111111111100000000000
00000000000000000000000000000000111000000000000000000000000000000000001111111111111111111111111111111111111111111111111111111111111111111111111110
00000000000000000000000000000000111000000000000000000000000000000000001111111111111111111111111111111111111111111111111111111111111111111111111110
00000000000000000000000000000000111000000000000000000000000000000000001111111111111111111111111111111111111111111111111111111111111111111111111110
00000000000000000000000000000000111000000000000000000000000000000000001111111111111111111111111111111111111111111111111111111111111111111111111110
00000000000000000000000000000000111000000000000000000000000000000000001111111111111111111111111111111111111111111111111111111111111111111111111110
00000000000000000000000000000000111000000000000000000000000000000000000000001111111111111111111111111111111111111111111111111111111111111111111110
00000000000000000000000000000011111110000000000000000000000000000000000000001111111111111111111111111111111111111111111111111111111111100000000000
00000000000000000000000000000011111110000000000000000000000000000000000000001111111111111111111111111111111111111111111111111111111111100000000000
00000000000000000000000000000011111110000000000000000000000000000000000000001111111111111111111111111111111111111111111111111111111110000000000000
00000000000000000000000000000011111110000000000000000000000000000000000000001111111111111111111111111111111111111111111111111111111110000000000000
00000000000000000000000000000111111110000000000000000000000000000000000000001111111111111111111111111111111111111111111111111111100000000000000000
00000000000000000000000000000111111110000000000000000000000000000000000000001111111111111111111111111111111111111111111111111111100000000000000000
00000000000000000000000000011111111110000000000000000000000000000000000000001111111111111111111111111111111111111111111111111110000000000000000000
00000000000000000000000000011111111110000000000000000000000000000000000000001111111111111111111111111111111111111111111111111110000000000000000000
00000000000000000000000000011111111110000000000000000000000000000000000000111111111111111111111111111111111111111111111111111110000000000000000000
00000000000000000000000011111111111110000000000000000000000000000000000000111111111111111111111111111111111111111111111111111110000000000000000000
00000000000000000000000011111111111111111110000000000000000000000000001111111111111110000000011111111111111111111111111111111000000000000000000000
00000000000000000000001111111111111111111110000000000000000000000000001111111111111110000000011111111111111111111111111111111000000000000000000000
00000000000000000000001111111111111111111111100000000000000000000000001111111111111110000000011111111111111111111111111111111000000000000000000000
00000000000000000000001111111111111111111111100000000000000000000000001111111111111110000000011111111111111111111111111111111000000000000000000000
00000000000000000001111111111111111111111111111110000000000000000001111111111111111110000000000001111111111111111111111111111000000000000000000000
00000000000000000001111111111111111111111111111110000000000000000001111111111111111110000000000001111111111111111111111111111000000000000000000000
00000000000000001111111111111111111111111111111111111111111111111111111111111111111110000000000001111111111111111111111111111000000000000000000000
00000000000000001111111111111111111111111111111111111111111111111111111111111111111110000000000001111111111111111111111111111000000000000000000000
00000000000000001111111111111111111111111111111111111111111111111111111111111111111111100000000000000111111111111111111111111111100000000000000000
00000000000000001111111111111111111111111111111111111111111111111111111111111111111111100000000000000111111111111111111111111111100000000000000000
00000000000000001111111111111111111111111111111111111111111111111111111111111111111111111110000000000111111111111111111111111111111000000000000000
00000000000000001111111111111111111111111111111111111111111111111111111111111111111111111110000000000111111111111111111111111111111000000000000000
00000000000000001111111111111111111111111111111111111111111111111111111111111111111111111110000000000111111111111111111111111111111000000000000000
00000000000000001111111111111111111111111100000000000000000000111111111111111111111111111110000000000111111111111111111111111111111000000000000000
00000000000000111111111111111111111111111000000000000000000000111111111111111111111111111110000001111111111111111111111111111111111000000000000000
00000000000000111111111111111111111111100000000000000000000000001111111111111111111111111110000001111111111111111111111111111111100000000000000000
00000000000011111111111111111111111111100000000000000000000000001111111111111111111111111111111111111111111111111111111111111111100000000000000000
00000000000011111111111111111111111111100000000000000000000000001111111111111111111111111111111111111111111111111111111111111000000000000000000000
00000000000011111111111111111111111111100000000000000000000000001111111111111111111111111111111111111111111111111111111111111000000000000000000000
00000000000011111111111111111111111110000000000000000000000000001111111111111111111111111111111111111111111111111111111111111000000000000000000000
00000000111111111111111111111111111110000000000000000000000000001111111111111111111111111111111111111111111111111111111111111000000000000000000000
00000000111111111111111111111111111000000000000000000000000000000011111111111111100000000011111111111111111111111111111111111000000000000000000000
00000000111111111111111111111111111000000000000000000000000000000011111111111111100000000011111111111111111111111111111111111000000000000000000000
00000000111111111111111111111111111000000000000000000000000000000011111111111110000000000000111111111111111111111111111111111000000000000000000000
00000000111111111111111111111111111000000000000000000000000000000011111111111110000000000000111111111111111111111111111111111000000000000000000000
00000000000011111111111111111111111000000000000000000000000000000011111111100000000000000000111111111111111111111111111111111000000000000000000000
00000000000011111111111111111111111000000000000000000000000000000011111111100000000000000000111111111111111111111111111111111000000000000000000000
00000000000011111111111111111111111000000000000000000000000000000011111111100000000000000000111111111111111111111111111111111000000000000000000000
00000000000011111111111111111111111000000000000000000000000000000011111111100000000000000000111111111111111111111111111111111000000000000000000000
00000000000011111111111111111111111000000000000000000000000000000011111111100000000000000000111111111111111111111111111111111000000000000000000000
00000000000011111111111111111111111000000000000000000000000001111111111111100000000000000000111111111111111111111111111111111111100000000000000000
00000000000000111111111111111111111000000000000000000000000001111111111111100000000000000000111111111111111111111111111111111111100000000000000000
00000000000000111111111111111111111000000000000000000000000111111111111111100000000000000111111111111111111111111111111111111111111110000000000000
00000000000000001111111111111111111000000000000000000000000111111111111111100000000000000111111111111111111111111111111111111111111110000000000000
00000000000000001111111111111111111000000000000000000000011111111111111111100000000000000111111111111111111111111111111111111111111110000000000000
00000000000000000111111111111111000000000000000000000000011111111111111111100000000000000111111111111111111111111111111111111111111000000000000000
00000000000000000011111111111110000000000000000000000001111111111111111110000000000000000111111111111111111111111111111111111111111000000000000000
00000000000000000000111111111000000000000000000000000001111111111111111110000000000000000111111111111111111000000000001111111111100000000000000000
00000000000000000000111111111000000000000000000000000001111111111111111000000000000000001111111111111111111000000000001111111111100000000000000000
00000000000000000000000000000000000000000000000000000001111111111111111000000000000000000111111111111110000000000000000000100000000000000000000000
00000000000000000000000000000000000000000000000000000001111111111111100000000000000000000111111111111000000000000000000000100000000000000000000000
00000000000000000000000000000000000000000000000000000001111111111111100000000000000000000111111111111000000000000000000000000000000000000000000000
00000000000000000000000000000000000000000000000000000000011111111110000000000000000000000000000000000000000000000000000000000000000000000000000000
00000000000000000000000000000000000000000000000000000000011111111110000000000000000000000000000000000000000000000000000000000000000000000000000000
