132
232
-5
92
00000000000000000000000000000000000000000000000000000000000000000000000000000000000000000000000000000
00000000000000000000000000000000000000000000000011111111111111111111111111111111000000000000000000000
00000000000000000000000000000000000000000000000011111111111111111111111111111111000000000000000000000
00000000000000000000000000000000000000000000000011111111111111111111111111111111000000000000000000000
00000000000000000000000000000000000000000000000011111111111111111111111111111111000000000000000000000
00000000000000000000000000000000000011111111111111111111111111111111111111111111111111110000000000000
00000000000000000000000000000000000011111111111111111111111111111111111111111111111111110000000000000
00000000000000000000000000000000000011111111111111111111111111111111111111111111111111110000000000000
00000000000000000000000000000000000011111111111111111111111111111111111111111111111111110000000000000
00000000000000000000000000000000111111111111111111111111111111111111111111111111111111110000000000000
00000000000000000000000000000000111111111111111111111111111111111111111111111111111111110000000000000
00000000000000000000000000000000111111111111111111111111111111111111111111111111111111110000000000000
00000000000000000000000000000000111111111111111111111111111111111111111111111111111111110000000000000
00000000000000000000000000001111111111111111111111111111111111111111111111111111111111111111111111110
00000000000000000000000000001111111111111111111111111111111111111111111111111111111111111111111111110
00000000000000000000000000001111111111111111111111111111111111111111111111111111111111111111111111110
00000000000000000000000000001111111111111111111111111111111111111111111111111111111111111111111111110
00000000000000000000111111111111111111111111111111111111111111111111111111111111111111111111111111110
00000000000000000000111111111111111111111111111111111111111111111111111111111111111111111111111111110
00000000000000000000111111111111111111111111111111111111111111111111111111111111111111111111111111110
00000000000000000000111111111111111111111111111111111111111111111111111111111111111111111111111111110
00000000000000001111111111111111111111111111111111111111111111111111111111111111111111111111111111110
00000000000000001111111111111111111111111111111111111111111111111111111111111111111111111111111111110
00000000000000001111111111111111111111111111111111111111111111111111111111111111111111111111111111110
00000000000000001111111111111111111111111111111111111111111111111111111111111111111111111111111111110
00000000000011111111111111111111111111111111111111111111111111111111111111111111111111111111111111110
00000000000011111111111111111111111111111111111111111111111111111111111111111111111111111111111111110
00000000000011111111111111111111111111111111111111111111111111111111111111111111111111111111111111110
00000000000011111111111111111111111111111111111111111111111111111111111111111111111111111111111111110
00000000000011111111111111111111111111111111111111111111111111111111111111111111111111111111111111110
00000000000011111111111111111111111111111111111111111111111111111111111111111111111111111111111111110
00000000000011111111111111111111111111111111111111111111111111111111111111111111111111111111111111110
00000000000011111111111111111111111111111111111111111111111111111111111111111111111111111111111111110
00001111111111111111111111111111111111111111111111111111111111111111111111111111111111111111111111110
00001111111111111111111111111111111111111111111111111111111111111111111111111111111111111111111111110
00001111111111111111111111111111111111111111111111111111111111111111111111111111111111111111111111110
00001111111111111111111111111111111111111111111111111111111111111111111111111111111111111111111111110
00001111111111111111111111111111111111111111111111111111111111111111111111111111111111111111111100000
00001111111111111111111111111111111111111111111111111111111111111111111111111111111111111111111100000
00001111111111111111111111111111111111111111111111111111111111111111111111111111111111111111111100000
00001111111111111111111111111111111111111111111111111111111111111111111111111111111111111111111100000
11111111111111111111111111111111111111111111111111111111111111111111111111111111111111111111000000000
11111111111111111111111111111111111111111111111111111111111111111111111111111111111111111111000000000
11111111111111111111111111111111111111111111111111111111111111111111111111111111111111111111000000000
11111111111111111111111111111111111111111111111111111111111111111111111111111111111111111111000000000
11111111111111111111111111111111111111111111111111111111111111111111111111111111111111110000000000000
11111111111111111111111111111111111111111111111111111111111111111111111111111111111111110000000000000
11111111111111111111111111111111111111111111111111111111111111111111111111111111111111110000000000000
11111111111111111111111111111111111111111111111111111111111111111111111111111111111111110000000000000
11111111111111111111111111111111111111111111111111111111111111111111111111111111000000000000000000000
11111111111111111111111111111111111111111111111111111111111111111111111111111111000000000000000000000
11111111111111111111111111111111111111111111111111111111111111111111111111111111000000000000000000000
11111111111111111111111111111111111111111111111111111111111111111111111111111111000000000000000000000
11111111111111111111111111111111111111111111111111111111111111111111111100000000000000000000000000000
11111111111111111111111111111111111111111111111111111111111111111111111100000000000000000000000000000
11111111111111111111111111111111111111111111111111111111111111111111111100000000000000000000000000000
11111111111111111111111111111111111111111111111111111111111111111111111100000000000000000000000000000
11111111111111111111111111111111111111111111111111111111111111111111000000000000000000000000000000000
11111111111111111111111111111111111111111111111111111111111111111111000000000000000000000000000000000
11111111111111111111111111111111111111111111111111111111111111111111000000000000000000000000000000000
11111111111111111111111111111111111111111111111111111111111111111111000000000000000000000000000000000
00001111111111111111111111111111111111111111111111111111111111110000000000000000000000000000000000000
00001111111111111111111111111111111111111111111111111111111111110000000000000000000000000000000000000
00001111111111111111111111111111111111111111111111111111111111110000000000000000000000000000000000000
00001111111111111111111111111111111111111111111111111111111111110000000000000000000000000000000000000
00000000111111111111111111111111111111111111111111111111111100000000000000000000000000000000000000000
00000000111111111111111111111111111111111111111111111111111100000000000000000000000000000000000000000
00000000111111111111111111111111111111111111111111111111111100000000000000000000000000000000000000000
00000000111111111111111111111111111111111111111111111111111100000000000000000000000000000000000000000
11110000111111111111111111111111111111111111111111111111111100000000000000000000000000000000000000000
11110000111111111111111111111111111111111111111111111111111100000000000000000000000000000000000000000
00110000111111111111111111111111111111111111111111111111111100000000000000000000000000000000000000000
00110000111111111111111111111111111111111111111111111111111100000000000000000000000000000000000000000
00000000111111111111111111111111111111111111111111111111000000000000000000000000000000000000000000000
00000000111111111111111111111111111111111111111111111111000000000000000000000000000000000000000000000
00000000111111111111111111111111111111111111111111111111000000000000000000000000000000000000000000000
00000000111111111111111111111111111111111111111111111111000000000000000000000000000000000000000000000
00000000111111111111111111111111111111111111000000000000000000000000000000000000000000000000000000000
00000000111111111111111111111111111111111111000000000000000000000000000000000000000000000000000000000
00000000111111111111111111111111111111111111000000000000000000000000000000000000000000000000000000000
00000000111111111111111111111111111111111111000000000000000000000000000000000000000000000000000000000
00000000000000001111111111111111111111111111000000000000000011000000000000000000000000000000000000000
00000000000000001111111111111111111111111111000000000000000011000000000000000000000000000000000000000
00000000000000001111111111111111111111111111000000000000000000000000000000000000000000000000000000000
00000000000000001111111111111111111111111111000000000000000000000000000000000000000000000000000000000
00000000000000000000000011111111111111111111000000000000110000000000000000000000000000000000000000000
00000000000000000000000011111111111111111111000000000000110000000000000000000000000000000000000000000
00000000000000000000000011111111111111111111000000000000000000000000000000000000000000000000000000000
00000000000000000000000011111111111111111111000000000000000000000000000000000000000000000000000000000
00000000000000000000111111111111111111110000000000000000000000000000000000000000000000000000000000000
00000000000000000000111111111111111111110000000000000000000000000000000000000000000000000000000000000
00000000000000000000000011111111111111110000000000000000000000000000000000000000000000000000000000000
00000000000000000000000011111111111111110000000000000000000000000000000000000000000000000000000000000
00000000000000000000000011111111111111111111000000000000000000000000000000000000000000000000000000000
00000000000000000000000011111111111111111111000000000000000000000000000000000000000000000000000000000
00000000000000000000000011111111111111110000000000000000000000000000000000000000000000000000000000000
00000000000000000000000011111111111111110000000000000000000000000000000000000000000000000000000000000
00000000000000000000000000111111111111110000000000000000000000000000000000000000000000000000000000000
