-50
85
-67
99
0000000000000000000000000000000000000000000000000000000000000000000000000000000000000000000000000000000000000000000000000000000000000000
0000000000000000000000000000000000000000000000000000000000000000000000000000011111111111111111111111111110000000000001111111100000000000
0000000000000000000000000000000000000000000000000000000000000000000000000000111111111111111111111111111110000000000011111111100000000000
0000000000000000000000000000000000000000000000000000000000000000000000000001111111111111111111111111111111100000001111111111100000000000
0000000000000000000000000000000000000000000000000000000000000000000000000001111111111111111111111111111111100000001111111111100000000000
0000000000000000000000000000000000000000000000000000000000000000000000000011111111111111111111111111111111111111111111111111111111111110
0000000000000000000000000000000000000000000000000000000000000000000000000011111111111111111111111111111111111111111111111111111111111110
0000000000000000000000000000000000000000000000000000000000000000011000000111111111111111111111111111111111111111111111111111111111111110
0000000000000000000000000000000000000000000000000000000000000000111100001111111111111111111111111111111111111111111111111111111111111110
0000000000000000000000000000000000000000000000000000000000000111111111111111111111111111111111111111111111111111111111111111111111111110
0000000000000000000000000000000000000000000000000000000000001111111111111111111111111111111111111111111111111111111111111111111111111110
0000000000000000000000000000000000000000000000000000000000011111111111111111111111111111111111111111111111111111111111111111111111111110
0000000000000000000000000000000000000000000000000000000000111111111111111111111111111111111111111111111111111111111111111111111111111110
0000000000000000000000000000000000000000000000000000011111111111111111111111111111111111111111111111111111111111111111111111111111111000
0000000000000000000000000000000000000000000000000000111111111111111111111111111111111111111111111111111111111111111111111111111111110000
0000000000000000000000000000000000000000000000000001111111111111111111111111111111111111111111111111111111111111111111111111111110000000
0000000000000000000000000000000000000000000000000011111111111111111111111111111111111111111111111111111111111111111111111111111100000000
0000000000000000000000000000000000000000000000000111111111111111111111111111111111111111111111111111111111111111111111111111111000000000
0000000000000000000000000000000000000000000000001111111111111111111111111111111111111111111111111111111111111111111111111111110000000000
0000000000000000000000000000000000000000000000111111111111111111111111111111111111111111111111111111111111111111111111111111100000000000
0000000000000000000000000000000000000000000011111111111111111111111111111111111111111111111111111111111111111111111111111111100000000000
0000000000000000000000000000000000000000000111111111111111111111111111111111111111111111111111111111111111111111111111111111100000000000
0000000000000000000000000000000000000000001111111111111111111111111111111111111111111111111111111111111111111111111111111111100000000000
0000000000000000000000000000000000000000001111111111111111111111111111111111111111111111111111111111111111111111111111111111100000000000
0000000000000000000000000000000000000000011111111111111111111111111111111111111111111111111111111111111111111111111111111111100000000000
0000000000000000000000000000000000000000011111111111111111111111111111111111111111111111111111111111111111111111111111111111000000000000
0000000000000000000000000000000000000000111111111111111111111111111111111000111111111111111111111111111111111111111111111110000000000000
0000000000000000000000000000000000000000111111111111111111111111111110000000111111111111111111111111111111111111111111111100000000000000
0000000000000000000000000000000000000001111111111111111111111111110000000000111111111111111111111111111111111111111111111000000000000000
0000000000000000000000000000000000000011111111111111111111111111000000000000111111111111111111111111111111111111111111111000000000000000
0000000000000000000000000000000000000011111111111111111111111110000000000001111111111111111111111111111111111111111111111000000000000000
0000000000000000000000000000000000000111111111111111111111111110000000000011111111111111111111111111111111111111111111111000000000000000
0000000000000000000000000000000000000111111111111111111111111110000000000111111111111111111111111111111111111111111111111000000000000000
0000000000000000000000000000000000000111111111111111111111111110000000000111111111111111111111111111111111111111111111111000000000000000
0000000000000000000000000000000000000111111111111111111111111110000000000111111111111111111111111111111111111111111111111000000000000000
0000000000000000000000000000000000000111111111111111111111111110000000000111111111111111111111111111111111111111111111111110000000000000
0000000000000000000000000000000000000111111111111111111111111110000000001111111111111111111111111111111111111111111111111110000000000000
0000000000000000000000000000000000000111111111111111111111111111111111111111111111111111111111111111111111111111111111111111100000000000
0000000000000000000000000000000000000011111111111111111111111111111111111111111111111111111111111111111111111111111111111111100000000000
0000000000000000000000000000000000000000011111111111111111111111111111111111111111111111111111110011111111111111111111111111100000000000
0000000000000000000000000000000000000000001111111111111111111111111111111111111111111111111111100001111111111111111111111111100000000000
0000000000000000000000000000000000000000000111111111111111111111111111111111111111111111111110000000111111111111111111111111100000000000
0000000000000000000000000000000000000000000011111111111111111111111111111111111111111111111100000000001111111111111111111111100000000000
0000000000000000000000000000000000000000000001111111111111111111111111111111111111111111111000000000000111111111111111111111100000000000
0000000000000000000000000000000000000000000001111111111111111111111111111111111111111110000000000000000111111111111111111111100000000000
0000000000000000000000000000000000000000000011111111111111111111111111111111111111111110000000000000000111111111111111111111100000000000
0000000000000000000000000000000000000000000011111111111111111111111111111111111111111110000000000000000111111111111111111111100000000000
0000000000000000000000000000000000000000000111111111111111111111111111111111111111111110000000000000001111111111111111111111100000000000
0000000000000000000000000000000000000000000111111111111111111111111111111111111111111110000000000000011111111111111111111111100000000000
0000000000000000000000000000000000000000000111111111111111111111111111111111111111111110000000000000011111111111111111111111000000000000
0000000000000000000000000000000000000000000111111111111111111111111111111111111111111110000000000000111111111111111111111110000000000000
0000000000000000000000000000000000000000001111111111111111111111111111111111111111111110000000011111111111111111111111111110000000000000
0000000000000000000000000000000000000000011111111111111111111111111111111111111111111110000000111111111111111111111111111110000000000000
0000000000000000000000000000000000000000011111111111111111111111111111111111111111111110000000111111111111111111111111111100000000000000
0000000000000000000000000000000000000000111111111111111111111111111111111111111111111110000001111111111111111111111111111000000000000000
0000000000000000000000000000000000000001111111111111111111111111111111111111111111111111111111111111111111111111111111111000000000000000
0000000000000000000000000000000000000011111111111111111111111111111111111111111111111111111111111111111111111111111111111000000000000000
0000000000000000000000000000000000000111111111111111111111111111111111111111111111111111111111111111111111111111111111111000000000000000
0000000000011111000000000000000000001111111111111111111111111111111111111111111111111111111111111111111111111111111111111000000000000000
0000000001111111100000000000000000011111111111111111111111111111111111111111111111111111111111111111111111111111111111111110000000000000
0000000001111111110000000000000000111111111111111111111111111111111111111111111111111111111111111111111111111111111111111110000000000000
0000000011111111111000000000000001111111111111111111111111111111111111111111111111111111111111111111111111111111111111111111100000000000
0000000011111111111100000000000011111111111111111111111111111111111111111111111111111111111111111111111111111111111111111111100000000000
0000000011111111111111111000000111111111111111111111111111111111111111111111111111111111111111111111111111111111111111111111100000000000
0000000011111111111111111111111111111111111111111111111111111111111111111111111111111111111111111111111111111111111111111111100000000000
0000000111111111111111111111111111111111111111111111111111111111111111111111111111111111111111111111111111111111111111111111100000000000
0000001111111111111111111111111111111111111111111111111111111111111111111111111111111111111111111111111111111111111111111111100000000000
0000001111111111111111111111111111111111111111111111111111111111111111111111111111111111111111111111111111111111111111111111100000000000
0000011111111111111111111111111111111111111111111111111111111111111111111111111111111111111111111111111111111111111111111111100000000000
0000111111111111111111111111111111111111111111111111111111111111111111111111111111111111111111111111111111111111111111111111100000000000
0000111111111111111111111111111111111111111111111111111111111111111111111111111111111111111111111111111111111111111111111111100000000000
0000111111111111111111111111111111111111111111111111111111111111111111111111111111111111111111111111111111111111111111111111100000000000
0000111111111111111111111111111111111111111111111111111111111111111111111111111111111111111111111111111111111111111111111111100000000000
0000111111111111111111111111111111111111111111111111111111111111111111111111111111111111111111111111111111111111111111111111100000000000
0000011111111111111111111111111111111111111111111111111111111111111111111111111111111111111111111111111111111111111111111111100000000000
0000011111111111111111111111111111111111111111111111111111111111111111111111111111111111111111111111111111111111111111111111100000000000
0000111111111111111111111111111111111111111111111111111111111111111111111111111111111111111111111111111111111111111111111111100000000000
0001111111111111111111111111111111111111111111111111111111111111111111111111111111111111111111111111111111111111111111111111100000000000
0011111111111111111111111111111111111111111111111111111111111111111111111111111111111000000000000000000000000000000000000000000000000000
0011111111111111111111111111111111111111111111111110000000011111111111111111111111000000000000000000000000000000000000000000000000000000
0111111111111111111111111111111111111111111111111100000000001111111111111111111110000000000000000000000000000000000000000000000000000000
1111111111111111111111111111111111111111111111110000000000001111111111111111110000000000000000000000000000000000000000000000000000000000
1111111111111111111111111111111111111111111111100000000000001111111111111111100000000000000000000000000000000000000000000000000000000000
1111111111111111111111111111111111111111111111100000000000001111111111111111100000000000000000000000000000000000000000000000000000000000
1111111111111111111111111111111111111111111111100000000000001111111111111111100000000000000000000000000000000000000000000000000000000000
1111111111111111111111111111111111111111111111100000000000011111111111111111100000000000000000000000000000000000000000000000000000000000
1111111111111111111111111111111111111111111111100000000000011111111111111111100000000000000000000000000000000000000000000000000000000000
1111111111111111111111111111111111111111111111100000000000111111111111111111100000000000000000000000000000000000000000000000000000000000
1111111111111111111111111111111111111111111111100000000001111111111111111000000000000000000000000000000000000000000000000000000000000000
1111111111111111111111111111111111111111111111100000000001111111111111110000000000000000000000000000000000000000000000000000000000000000
1111111111111111111111111111111111111111111111110000000001111111111111000000000000000000000000000000000000000000000000000000000000000000
1111111111111111111111111111111111111111111111111111111111111111111100000000000000000000000000000000000000000000000000000000000000000000
1111111111111111111111111111111111111111111111111111111111111111110000000000000000000000000000000000000000000000000000000000000000000000
1111111111111111111111111111111111111111111111111111111111111111000000000000000000000000000000000000000000000000000000000000000000000000
1111111111111111111111111111111111111111111111111111111111111110000000000000000000000000000000000000000000000000000000000000000000000000
1111111111111111111111111111111111111111111111111111111111111100000000000000000000000000000000000000000000000000000000000000000000000000
1111111111111111111111111111111111111111111111111111111111111000000000000000000000000000000000000000000000000000000000000000000000000000
1111111111111111111111111111111111111111111111111111111111111000000000000000000000000000000000000000000000000000000000000000000000000000
1111111111111111111111111111111111111111111111111111111111111000000000000000000000000000000000000000000000000000000000000000000000000000
1111111111111111111111111111111111111111111111111111111111111000000000000000000000000000000000000000000000000000000000000000000000000000
1111111111111111111111111111111111111111111111111111111111111000000000000000000000000000000000000000000000000000000000000000000000000000
1111111111111111111111111111111111111111111111111111111111111110000000000000000000000000000000000000000000011111111110000000000000000000
1111111111111111111111111111111111111111111111111111111111111110000000000000000000000000000000000000000000111111111110000000000000000000
1111111111111111111111111111111111111111111111111111111111111111111000000000000000000000000000000011111111111111111111100000000000000000
1111111111111111111111111111111111111111111111111111111111111111111000000000000000000000000000000011111111111111111111100000000000000000
1111111111111111111111111111111111111111111111111111111111111111111000000000000000000000000000000111111111111111111111111000000000000000
1111111111111111111111111111111111111111111111111111111111111111111000000000000000000000000000001111111111111111111111111000000000000000
1111111111111111111111111111111111111111111111111111111111111111111000000000000000000000000000001111111111111111111111111110000000000000
1111111111111111111111111111111111111111111111111111111111111111111000000000000000000000000000011111111111111111111111111110000000000000
1111111111111111111111111111111111111111111111111111111111111111111000000000000000000000000000111111111111111111111111111111100000000000
1111111111111111111111111111111111111111111111111111111111111111111000000000000000000000000000111111111111111111111111111111100000000000
1111111111111111111111111111111111111111111111111111111111111111111111100000000000000000000001111111111111111111111111111111100000000000
1111111111111111111111111111111111111111111111111111111111111111111111100000000000000000000001111111111111111111111111111111100000000000
1111111111111111111111111111111111111111111111111111111111111111111111111000000000000000000001111111111111111111111111111111111000000000
1111111111111111111111111111111111111111111111111111111111111111111111111000000000000000000001111111111111111111111111111111111000000000
1111111111111111111111111111111111111111111111111111111111111111111111111110000000000000000001111111111111111111111111111111111000000000
0111111111111111111111111111111111111111111111111111111111111111111111111110000000000000000011111111111111111111111111111111110000000000
0111111111111111111111111111111111111111111111111111111111111111111111111111111111111111111111111111111111111111111111111100000000000000
0111111111111111111111111111111111111111111111111111111111111111111111111111111111111111111111111111111111111111111111111000000000000000
0111111111111111111111111111111111111111111111111111111111111111111111111111111111111111111111111111111111111111111111111000000000000000
1111111111111111111111111111111111111111111111111111111111111111111111111111111111111111111111111111111111111111111111111000000000000000
1111111111111111111111111111111111111111111111111111111111111111111111111111111111111111111111111111111111111111111111111000000000000000
1111111111111111111111111111111111111111111111111111111111111111111111111111111111111111111111111111111111111111111111111000000000000000
1111111111111111111111111111111111111111111111111111111111111111111111111111111111111111111111111111111111111111111111111000000000000000
0111111111111111111111111111111111111111111111111111111111111111111111111111111111111111111111111111111111111111111111111000000000000000
0111111111111111111111111111111111111111111111111111111111111111111111111111111111111111111111111111111111111111111111110000000000000000
0011111111111111111111111111111111111111111111111111111111111111111111111000000000000000001111111111111111111111100000000000000000000000
0001111111111111111111111111111111111111111111111111111111111111111111110000000000000000000111111111111111111111000000000000000000000000
0001111111111111111111111111111111111111111111111111111111111111111111000000000000000000000111111111111111111111000000000000000000000000
0001111111111111111111111111111111111111111111111111111111111111111110000000000000000000000111111111111111111100000000000000000000000000
0001111111111111111111111111111111111111111111111111111111111111111100000000000000000000000001111000000000000000000000000000000000000000
0000111111111111111111111111111111111111111111111111111111111111111000000000000000000000000000000000000000000000000000000000000000000000
0000111111111111111111111111111111111111111111111111111111111111110000000000000000000000000000000000000000000000000000000000000000000000
0000111111111111111111111111111111111111111111111111111111111111100000000000000000000000000000000000000000000000000000000000000000000000
0000111111111111111111111111111111111111111111111111111111111111000000000000000000000000000000000000000000000000000000000000000000000000
0000111111111111111111111111111111111111111111111111111111111110000000000000000000000000000000000000000000000000000000000000000000000000
0000111111111111111111111111111111111111111111111111111111111100000000000000000000000000000000000000000000000000000000000000000000000000
0000111111111111111111111111111111111111111111111111111111111000000000000000000000000000000000000000000000000000000000000000000000000000
0000111111111111111111111111100000000111111111111111111111110000000000000000000000000000000000000000000000000000000000000000000000000000
0000111111111111111111111110000000000111111111111111111111100000000000000000000000000000000000000000000000000000000000000000000000000000
0000111111111111111111111000000000000111111111111111111111000000000000000000000000000000000000000000000000000000000000000000000000000000
0000111111111111111111110000000000000111111111111111111110000000000000000000000000000000000000000000000000000000000000000000000000000000
0000111111111111111111100000000000000111111111111111111100000000000000000000000000000000000000000000000000000000000000000000000000000000
0000111111111111111111100000000000000111111111111111111000000000000000000000000000000000000000000000000000000000000000000000000000000000
0000111111111111111111100000000000001111111111111111110000000000000000000000000000000000000000000000000000000000000000000000000000000000
0000111111111111111111100000000000001111111111111111100000000000000000000000000000000000000000000000000000000000000000000000000000000000
0000111111111111111111100000000000011111111111111110000000000000000000000000000000000000000000000000000000000000000000000000000000000000
0000111111111111111111100000000000111111111111111100000000000000000000000000000000000000000000000000000000000000000000000000000000000000
0000111111111111111111100000000000111111111111111000000000000000000000000000000000000000000000000000000000000000000000000000000000000000
0000111111111111111111110000000001111111111111110000000000000000000000000000000000000000000000000000000000000000000000000000000000000000
0000111111111111111111111000000011111111111111000000000000000000000000000000000000000000000000000000000000000000000000000000000000000000
0000111111111111111111111111111111111111111110000000000000000000000000000000000000000000000000000000000000000000000000000000000000000000
0000111111111111111111111111111111111111111000000000000000000000000000000000000000000000000000000000000000000000000000000000000000000000
0000111111111111111111111111111111111111110000000000000000000000000000000000000000000000000000000000000000000000000000000000000000000000
0000111111111111111111111111111111111111100000000000000000000000000000000000000000000000000000000000000000000000000000000000000000000000
0000111111111111111111111111111111111110000000000000000000000000000000000000000000000000000000000000000000000000000000000000000000000000
0000111111111111111111111111111111111100000000000000000000000000000000000000000000000000000000000000000000000000000000000000000000000000
0000111111111111111111111111111111111000000000000000000000000000000000000000000000000000000000000000000000000000000000000000000000000000
0000111111111111111111111111111111110000000000000000000000000000000000000000000000000000000000000000000000000000000000000000000000000000
0001111111111111111111111111111111000000000000000000000000000000000000000000000000000000000000000000000000000000000000000000000000000000
0001111111111111111111111111111110000000000000000000000000000000000000000000000000000000000000000000000000000000000000000000000000000000
0001111111111111111111111111110000000000000000000000000000000000000000000000000000000000000000000000000000000000000000000000000000000000
0000000111111111111111111100000000000000000000000000000000000000000000000000000000000000000000000000000000000000000000000000000000000000
0000000011111111111111110000000000000000000000000000000000000000000000000000000000000000000000000000000000000000000000000000000000000000
0000000001111111111111000000000000000000000000000000000000000000000000000000000000000000000000000000000000000000000000000000000000000000
0000000001111111111100000000000000000000000000000000000000000000000000000000000000000000000000000000000000000000000000000000000000000000
0000000000001111100000000000000000000000000000000000000000000000000000000000000000000000000000000000000000000000000000000000000000000000
